l2bn,l2ts,batchTimestamp,delay,batchPosterAddress,batchNumber,batchDataGas,l1BaseFeeWei
160357216,1702647477,1702646015,-1462,0xad8663715b08f41a3aec47cc,443529,1584880,57075900189
160357217,1702647477,1702646015,-1462,0xad8663715b08f41a3aec47cc,443530,1602760,57075900189
160357218,1702647477,1702646015,-1462,0xad8663715b08f41a3aec47cc,443531,1590276,57075900189
160360326,1702648257,1702646771,-1486,0xad8663715b08f41a3aec47cc,443532,1590226,51951411695
160360327,1702648257,1702646771,-1486,0xad8663715b08f41a3aec47cc,443533,1603664,51951411695
160360328,1702648257,1702646771,-1486,0xad8663715b08f41a3aec47cc,443534,1601610,51951411695
160360329,1702648257,1702646771,-1486,0xad8663715b08f41a3aec47cc,443535,1607442,51951411695
160360331,1702648258,1702646771,-1487,0xad8663715b08f41a3aec47cc,443536,1603048,51951411695
160360332,1702648258,1702646771,-1487,0xad8663715b08f41a3aec47cc,443537,1587496,51951411695
160360333,1702648258,1702646771,-1487,0xad8663715b08f41a3aec47cc,443538,1578246,51951411695
160360334,1702648258,1702646771,-1487,0xad8663715b08f41a3aec47cc,443539,1475640,51951411695
160360335,1702648258,1702646771,-1487,0xad8663715b08f41a3aec47cc,443540,1574748,51951411695
160360336,1702648258,1702646771,-1487,0xad8663715b08f41a3aec47cc,443541,1588148,51951411695
160360341,1702648258,1702647491,-767,0xad8663715b08f41a3aec47cc,443542,1604312,51106427516
160360343,1702648258,1702647491,-767,0xad8663715b08f41a3aec47cc,443543,1585052,51106427516
160360344,1702648258,1702647491,-767,0xad8663715b08f41a3aec47cc,443544,1603450,51106427516
160360345,1702648258,1702647491,-767,0xad8663715b08f41a3aec47cc,443545,1604502,51106427516
160360346,1702648258,1702647491,-767,0xad8663715b08f41a3aec47cc,443546,1594212,51106427516
160360347,1702648258,1702647491,-767,0xad8663715b08f41a3aec47cc,443547,1592766,51106427516
160360348,1702648258,1702647503,-755,0xad8663715b08f41a3aec47cc,443548,1584574,57456048074
160360349,1702648258,1702647503,-755,0xad8663715b08f41a3aec47cc,443549,1602004,57456048074
160360350,1702648258,1702647503,-755,0xad8663715b08f41a3aec47cc,443550,1594854,57456048074
160360351,1702648258,1702647503,-755,0xad8663715b08f41a3aec47cc,443551,1596386,57456048074
160363337,1702649008,1702647551,-1457,0xad8663715b08f41a3aec47cc,443552,1573452,59462027121
160363338,1702649008,1702647551,-1457,0xad8663715b08f41a3aec47cc,443553,1593978,59462027121
160363339,1702649008,1702647551,-1457,0xad8663715b08f41a3aec47cc,443554,1596280,59462027121
160363340,1702649008,1702647551,-1457,0xad8663715b08f41a3aec47cc,443555,1586474,59462027121
160363341,1702649008,1702647551,-1457,0xad8663715b08f41a3aec47cc,443556,1601192,59462027121
160363342,1702649008,1702647551,-1457,0xad8663715b08f41a3aec47cc,443557,1499360,59462027121
160363344,1702649008,1702647587,-1421,0xad8663715b08f41a3aec47cc,443558,1588592,58667642418
160363345,1702649008,1702647587,-1421,0xad8663715b08f41a3aec47cc,443559,1595600,58667642418
160363346,1702649008,1702647587,-1421,0xad8663715b08f41a3aec47cc,443560,1601522,58667642418
160363347,1702649008,1702647587,-1421,0xad8663715b08f41a3aec47cc,443561,1598378,58667642418
160363410,1702649022,1702648259,-763,0xad8663715b08f41a3aec47cc,443562,1599860,51717945541
160363412,1702649023,1702648259,-764,0xad8663715b08f41a3aec47cc,443563,1595670,51717945541
160363413,1702649023,1702648259,-764,0xad8663715b08f41a3aec47cc,443564,1596148,51717945541
160363414,1702649023,1702648259,-764,0xad8663715b08f41a3aec47cc,443565,1603680,51717945541
160363415,1702649023,1702648259,-764,0xad8663715b08f41a3aec47cc,443566,1604674,51717945541
160363416,1702649023,1702648259,-764,0xad8663715b08f41a3aec47cc,443567,1597138,51717945541
160363417,1702649023,1702648259,-764,0xad8663715b08f41a3aec47cc,443568,1571558,51717945541
160363418,1702649023,1702648271,-752,0xad8663715b08f41a3aec47cc,443569,1601354,54207956023
160363419,1702649023,1702648271,-752,0xad8663715b08f41a3aec47cc,443570,1600494,54207956023
160363420,1702649023,1702648271,-752,0xad8663715b08f41a3aec47cc,443571,1602594,54207956023
160363421,1702649023,1702648319,-704,0xad8663715b08f41a3aec47cc,443572,1582594,53624893348
160363422,1702649023,1702648319,-704,0xad8663715b08f41a3aec47cc,443573,1573020,53624893348
160363423,1702649023,1702648319,-704,0xad8663715b08f41a3aec47cc,443574,1586094,53624893348
160363424,1702649023,1702648319,-704,0xad8663715b08f41a3aec47cc,443575,1585034,53624893348
160363425,1702649023,1702648319,-704,0xad8663715b08f41a3aec47cc,443576,1584456,53624893348
160363426,1702649023,1702648319,-704,0xad8663715b08f41a3aec47cc,443577,1603078,53624893348
160363427,1702649023,1702648319,-704,0xad8663715b08f41a3aec47cc,443578,1582296,53624893348
160369623,1702650583,1702649327,-1256,0xad8663715b08f41a3aec47cc,443579,1574514,65192938225
160369625,1702650583,1702649327,-1256,0xad8663715b08f41a3aec47cc,443580,1573060,65192938225
160369626,1702650583,1702649327,-1256,0xad8663715b08f41a3aec47cc,443581,1572792,65192938225
160369627,1702650583,1702649327,-1256,0xad8663715b08f41a3aec47cc,443582,1584986,65192938225
160369628,1702650583,1702649327,-1256,0xad8663715b08f41a3aec47cc,443583,1600532,65192938225
160369629,1702650583,1702649327,-1256,0xad8663715b08f41a3aec47cc,443584,1597146,65192938225
160369630,1702650583,1702649327,-1256,0xad8663715b08f41a3aec47cc,443585,1582490,65192938225
160369631,1702650583,1702649327,-1256,0xad8663715b08f41a3aec47cc,443586,1586600,65192938225
160369634,1702650583,1702649531,-1052,0xad8663715b08f41a3aec47cc,443587,1590290,59491680290
160369635,1702650583,1702649531,-1052,0xad8663715b08f41a3aec47cc,443588,1576074,59491680290
160369640,1702650583,1702649807,-776,0xad8663715b08f41a3aec47cc,443589,1588724,53344091305
160369641,1702650583,1702649807,-776,0xad8663715b08f41a3aec47cc,443590,1592010,53344091305
160369642,1702650583,1702649807,-776,0xad8663715b08f41a3aec47cc,443591,1602410,53344091305
160369644,1702650584,1702649807,-777,0xad8663715b08f41a3aec47cc,443592,1603486,53344091305
160373051,1702651438,1702649819,-1619,0xad8663715b08f41a3aec47cc,443593,1599492,56750215111
160373052,1702651438,1702649819,-1619,0xad8663715b08f41a3aec47cc,443594,1573156,56750215111
160373053,1702651438,1702649819,-1619,0xad8663715b08f41a3aec47cc,443595,1597810,56750215111
160373054,1702651438,1702649819,-1619,0xad8663715b08f41a3aec47cc,443596,1602238,56750215111
160373055,1702651438,1702649867,-1571,0xad8663715b08f41a3aec47cc,443597,1596196,60552351593
160373056,1702651438,1702649867,-1571,0xad8663715b08f41a3aec47cc,443598,1595342,60552351593
160373057,1702651438,1702649867,-1571,0xad8663715b08f41a3aec47cc,443599,1579374,60552351593
160373058,1702651438,1702649867,-1571,0xad8663715b08f41a3aec47cc,443600,1582398,60552351593
160373060,1702651438,1702649927,-1511,0xad8663715b08f41a3aec47cc,443601,1571534,58999824472
160373061,1702651438,1702649927,-1511,0xad8663715b08f41a3aec47cc,443602,1593892,58999824472
160375451,1702652038,1702650647,-1391,0xad8663715b08f41a3aec47cc,443603,1589764,59903348952
160375452,1702652038,1702650647,-1391,0xad8663715b08f41a3aec47cc,443604,1608874,59903348952
160375453,1702652038,1702650647,-1391,0xad8663715b08f41a3aec47cc,443605,1598272,59903348952
160375454,1702652038,1702650647,-1391,0xad8663715b08f41a3aec47cc,443606,1601234,59903348952
160375455,1702652038,1702650647,-1391,0xad8663715b08f41a3aec47cc,443607,1570802,59903348952
160375458,1702652038,1702650875,-1163,0xad8663715b08f41a3aec47cc,443608,1585976,58415493906
160375459,1702652038,1702650875,-1163,0xad8663715b08f41a3aec47cc,443609,1577532,58415493906
160375460,1702652038,1702650875,-1163,0xad8663715b08f41a3aec47cc,443610,1595644,58415493906
160375461,1702652038,1702650875,-1163,0xad8663715b08f41a3aec47cc,443611,1561696,58415493906
160375462,1702652038,1702650875,-1163,0xad8663715b08f41a3aec47cc,443612,1591118,58415493906
160375468,1702652038,1702651439,-599,0xad8663715b08f41a3aec47cc,443613,1503262,58195598030
160375469,1702652038,1702651439,-599,0xad8663715b08f41a3aec47cc,443614,1569662,58195598030
160375470,1702652038,1702651439,-599,0xad8663715b08f41a3aec47cc,443615,1603848,58195598030
160375471,1702652038,1702651439,-599,0xad8663715b08f41a3aec47cc,443616,1580586,58195598030
160375472,1702652038,1702651463,-575,0xad8663715b08f41a3aec47cc,443617,1584924,58855191145
160375473,1702652038,1702651463,-575,0xad8663715b08f41a3aec47cc,443618,1603390,58855191145
160375474,1702652038,1702651463,-575,0xad8663715b08f41a3aec47cc,443619,1607760,58855191145
160375475,1702652038,1702651463,-575,0xad8663715b08f41a3aec47cc,443620,1579846,58855191145
160375477,1702652039,1702651463,-576,0xad8663715b08f41a3aec47cc,443621,1578060,58855191145
160375478,1702652039,1702651463,-576,0xad8663715b08f41a3aec47cc,443622,1590512,58855191145
160375479,1702652039,1702651487,-552,0xad8663715b08f41a3aec47cc,443623,1591162,59307547108
160375480,1702652039,1702651487,-552,0xad8663715b08f41a3aec47cc,443624,1607508,59307547108
160375481,1702652039,1702651487,-552,0xad8663715b08f41a3aec47cc,443625,1593038,59307547108
160375482,1702652039,1702651487,-552,0xad8663715b08f41a3aec47cc,443626,1582140,59307547108
160377999,1702652668,1702652039,-629,0xad8663715b08f41a3aec47cc,443627,1622678,56271054201
160378000,1702652668,1702652039,-629,0xad8663715b08f41a3aec47cc,443628,1581940,56271054201
160378001,1702652668,1702652039,-629,0xad8663715b08f41a3aec47cc,443629,1604546,56271054201
160378002,1702652668,1702652039,-629,0xad8663715b08f41a3aec47cc,443630,1575252,56271054201
160378003,1702652668,1702652039,-629,0xad8663715b08f41a3aec47cc,443631,1608748,56271054201
160378004,1702652668,1702652039,-629,0xad8663715b08f41a3aec47cc,443632,1606320,56271054201
160378005,1702652668,1702652039,-629,0xad8663715b08f41a3aec47cc,443633,1592276,56271054201
160378006,1702652668,1702652039,-629,0xad8663715b08f41a3aec47cc,443634,1608510,56271054201
160378007,1702652668,1702652039,-629,0xad8663715b08f41a3aec47cc,443635,1573706,56271054201
160378008,1702652668,1702652147,-521,0xad8663715b08f41a3aec47cc,443636,1580002,58305156782
160378009,1702652668,1702652147,-521,0xad8663715b08f41a3aec47cc,443637,1603006,58305156782
160378010,1702652668,1702652147,-521,0xad8663715b08f41a3aec47cc,443638,1582594,58305156782
160378011,1702652668,1702652147,-521,0xad8663715b08f41a3aec47cc,443639,1583312,58305156782
160378013,1702652668,1702652339,-329,0xad8663715b08f41a3aec47cc,443640,1604112,58593421913
160378015,1702652669,1702652339,-330,0xad8663715b08f41a3aec47cc,443641,1583860,58593421913
160378016,1702652669,1702652339,-330,0xad8663715b08f41a3aec47cc,443642,1599870,58593421913
160378017,1702652669,1702652339,-330,0xad8663715b08f41a3aec47cc,443643,1600958,58593421913
160378018,1702652669,1702652339,-330,0xad8663715b08f41a3aec47cc,443644,1604300,58593421913
160378019,1702652669,1702652339,-330,0xad8663715b08f41a3aec47cc,443645,1606702,58593421913
160378020,1702652669,1702652339,-330,0xad8663715b08f41a3aec47cc,443646,1583456,58593421913
160378021,1702652669,1702652339,-330,0xad8663715b08f41a3aec47cc,443647,1588990,58593421913
160378022,1702652669,1702652339,-330,0xad8663715b08f41a3aec47cc,443648,1567726,58593421913
160378023,1702652669,1702652351,-318,0xad8663715b08f41a3aec47cc,443649,1563122,65689189309
160378024,1702652669,1702652351,-318,0xad8663715b08f41a3aec47cc,443650,1569170,65689189309
160378025,1702652669,1702652351,-318,0xad8663715b08f41a3aec47cc,443651,1580176,65689189309
160378026,1702652669,1702652351,-318,0xad8663715b08f41a3aec47cc,443652,1604210,65689189309
160378027,1702652669,1702652351,-318,0xad8663715b08f41a3aec47cc,443653,1573490,65689189309
160378028,1702652669,1702652351,-318,0xad8663715b08f41a3aec47cc,443654,1563748,65689189309
160378029,1702652669,1702652351,-318,0xad8663715b08f41a3aec47cc,443655,1595110,65689189309
160378030,1702652669,1702652351,-318,0xad8663715b08f41a3aec47cc,443656,1578862,65689189309
160378032,1702652669,1702652375,-294,0xad8663715b08f41a3aec47cc,443657,1581672,68213152478
160378033,1702652669,1702652375,-294,0xad8663715b08f41a3aec47cc,443658,1590338,68213152478
160378034,1702652669,1702652375,-294,0xad8663715b08f41a3aec47cc,443659,1601650,68213152478
160379465,1702653028,1702652399,-629,0xad8663715b08f41a3aec47cc,443660,1570824,66637908991
160379466,1702653028,1702652399,-629,0xad8663715b08f41a3aec47cc,443661,1571628,66637908991
160379467,1702653028,1702652399,-629,0xad8663715b08f41a3aec47cc,443662,1606866,66637908991
160379468,1702653028,1702652399,-629,0xad8663715b08f41a3aec47cc,443663,1587196,66637908991
160379469,1702653028,1702652399,-629,0xad8663715b08f41a3aec47cc,443664,1567790,66637908991
160379470,1702653028,1702652411,-617,0xad8663715b08f41a3aec47cc,443665,1560034,74966692471
160379471,1702653028,1702652411,-617,0xad8663715b08f41a3aec47cc,443666,1559034,74966692471
160379472,1702653028,1702652411,-617,0xad8663715b08f41a3aec47cc,443667,1587892,74966692471
160379473,1702653028,1702652435,-593,0xad8663715b08f41a3aec47cc,443668,1578118,80001810379
160379474,1702653028,1702652435,-593,0xad8663715b08f41a3aec47cc,443669,1568544,80001810379
160379475,1702653028,1702652435,-593,0xad8663715b08f41a3aec47cc,443670,1572832,80001810379
160379476,1702653028,1702652435,-593,0xad8663715b08f41a3aec47cc,443671,1567412,80001810379
160379477,1702653028,1702652435,-593,0xad8663715b08f41a3aec47cc,443672,1585402,80001810379
160379478,1702653028,1702652435,-593,0xad8663715b08f41a3aec47cc,443673,1590518,80001810379
160379479,1702653028,1702652435,-593,0xad8663715b08f41a3aec47cc,443674,1609270,80001810379
160379480,1702653028,1702652459,-569,0xad8663715b08f41a3aec47cc,443675,1582058,86722411365
160379481,1702653028,1702652459,-569,0xad8663715b08f41a3aec47cc,443676,1559356,86722411365
160379483,1702653029,1702652459,-570,0xad8663715b08f41a3aec47cc,443677,1573860,86722411365
160379484,1702653029,1702652459,-570,0xad8663715b08f41a3aec47cc,443678,1605708,86722411365
160379485,1702653029,1702652459,-570,0xad8663715b08f41a3aec47cc,443679,1595938,86722411365
160379486,1702653029,1702652459,-570,0xad8663715b08f41a3aec47cc,443680,1593898,86722411365
160379487,1702653029,1702652459,-570,0xad8663715b08f41a3aec47cc,443681,1583692,86722411365
160379488,1702653029,1702652471,-558,0xad8663715b08f41a3aec47cc,443682,1595538,90155636723
160379489,1702653029,1702652471,-558,0xad8663715b08f41a3aec47cc,443683,1597662,90155636723
160379490,1702653029,1702652471,-558,0xad8663715b08f41a3aec47cc,443684,1578392,90155636723
160379491,1702653029,1702652471,-558,0xad8663715b08f41a3aec47cc,443685,1589008,90155636723
160379492,1702653029,1702652471,-558,0xad8663715b08f41a3aec47cc,443686,1592538,90155636723
160379493,1702653029,1702652471,-558,0xad8663715b08f41a3aec47cc,443687,1592990,90155636723
160379494,1702653029,1702652471,-558,0xad8663715b08f41a3aec47cc,443688,1557330,90155636723
160379495,1702653029,1702652483,-546,0xad8663715b08f41a3aec47cc,443689,1593468,98655597303
160379496,1702653029,1702652483,-546,0xad8663715b08f41a3aec47cc,443690,1588684,98655597303
160379497,1702653029,1702652483,-546,0xad8663715b08f41a3aec47cc,443691,1569586,98655597303
160379498,1702653029,1702652483,-546,0xad8663715b08f41a3aec47cc,443692,1617172,98655597303
160379499,1702653029,1702652483,-546,0xad8663715b08f41a3aec47cc,443693,1583852,98655597303
160379500,1702653029,1702652483,-546,0xad8663715b08f41a3aec47cc,443694,1605340,98655597303
160379501,1702653029,1702652507,-522,0xad8663715b08f41a3aec47cc,443695,1601582,94976829498
160379502,1702653029,1702652507,-522,0xad8663715b08f41a3aec47cc,443696,1598058,94976829498
160379503,1702653029,1702652507,-522,0xad8663715b08f41a3aec47cc,443697,1607852,94976829498
160379504,1702653029,1702652507,-522,0xad8663715b08f41a3aec47cc,443698,1605860,94976829498
160379505,1702653029,1702652507,-522,0xad8663715b08f41a3aec47cc,443699,1585050,94976829498
160379506,1702653029,1702652507,-522,0xad8663715b08f41a3aec47cc,443700,1575506,94976829498
160379507,1702653029,1702652507,-522,0xad8663715b08f41a3aec47cc,443701,1572266,94976829498
160379508,1702653029,1702652531,-498,0xad8663715b08f41a3aec47cc,443702,1589802,98102713858
160379509,1702653029,1702652531,-498,0xad8663715b08f41a3aec47cc,443703,1596784,98102713858
160379511,1702653029,1702652531,-498,0xad8663715b08f41a3aec47cc,443704,1597118,98102713858
160379512,1702653029,1702652531,-498,0xad8663715b08f41a3aec47cc,443705,1592324,98102713858
160379513,1702653029,1702652531,-498,0xad8663715b08f41a3aec47cc,443706,1597984,98102713858
160379514,1702653029,1702652531,-498,0xad8663715b08f41a3aec47cc,443707,1578032,98102713858
160379515,1702653029,1702652543,-486,0xad8663715b08f41a3aec47cc,443708,1587914,104981985994
160379516,1702653029,1702652543,-486,0xad8663715b08f41a3aec47cc,443709,1606458,104981985994
160379517,1702653029,1702652543,-486,0xad8663715b08f41a3aec47cc,443710,1573290,104981985994
160379518,1702653029,1702652543,-486,0xad8663715b08f41a3aec47cc,443711,1594342,104981985994
160379519,1702653029,1702652543,-486,0xad8663715b08f41a3aec47cc,443712,1564762,104981985994
160379520,1702653029,1702652543,-486,0xad8663715b08f41a3aec47cc,443713,1597580,104981985994
160379521,1702653029,1702652567,-462,0xad8663715b08f41a3aec47cc,443714,1611508,106344648312
160379522,1702653029,1702652567,-462,0xad8663715b08f41a3aec47cc,443715,1574820,106344648312
160379523,1702653029,1702652567,-462,0xad8663715b08f41a3aec47cc,443716,1611028,106344648312
160379524,1702653029,1702652567,-462,0xad8663715b08f41a3aec47cc,443717,1575448,106344648312
160379525,1702653029,1702652567,-462,0xad8663715b08f41a3aec47cc,443718,1573454,106344648312
160379526,1702653029,1702652567,-462,0xad8663715b08f41a3aec47cc,443719,1555210,106344648312
160379527,1702653029,1702652591,-438,0xad8663715b08f41a3aec47cc,443720,1584234,108511543184
160379528,1702653029,1702652591,-438,0xad8663715b08f41a3aec47cc,443721,1610530,108511543184
160379529,1702653029,1702652591,-438,0xad8663715b08f41a3aec47cc,443722,1593050,108511543184
160379530,1702653029,1702652591,-438,0xad8663715b08f41a3aec47cc,443723,1581428,108511543184
160379531,1702653029,1702652591,-438,0xad8663715b08f41a3aec47cc,443724,1569978,108511543184
160379532,1702653029,1702652591,-438,0xad8663715b08f41a3aec47cc,443725,1564660,108511543184
160379533,1702653029,1702652627,-402,0xad8663715b08f41a3aec47cc,443726,1605386,102848129599
160379534,1702653029,1702652627,-402,0xad8663715b08f41a3aec47cc,443727,1515012,102848129599
160379535,1702653029,1702652627,-402,0xad8663715b08f41a3aec47cc,443728,1587802,102848129599
160379536,1702653029,1702652627,-402,0xad8663715b08f41a3aec47cc,443729,1580506,102848129599
160379537,1702653029,1702652627,-402,0xad8663715b08f41a3aec47cc,443730,1602898,102848129599
160379538,1702653029,1702652627,-402,0xad8663715b08f41a3aec47cc,443731,1554274,102848129599
160379540,1702653029,1702652651,-378,0xad8663715b08f41a3aec47cc,443732,1603748,103938839754
160379541,1702653029,1702652651,-378,0xad8663715b08f41a3aec47cc,443733,1573126,103938839754
160379542,1702653029,1702652651,-378,0xad8663715b08f41a3aec47cc,443734,1584958,103938839754
160379543,1702653029,1702652651,-378,0xad8663715b08f41a3aec47cc,443735,1594102,103938839754
160379544,1702653029,1702652651,-378,0xad8663715b08f41a3aec47cc,443736,1604336,103938839754
160379545,1702653029,1702652651,-378,0xad8663715b08f41a3aec47cc,443737,1550682,103938839754
160379547,1702653029,1702652675,-354,0xad8663715b08f41a3aec47cc,443738,1581306,100982616105
160379548,1702653029,1702652675,-354,0xad8663715b08f41a3aec47cc,443739,1585798,100982616105
160379549,1702653029,1702652675,-354,0xad8663715b08f41a3aec47cc,443740,1578318,100982616105
160379550,1702653029,1702652675,-354,0xad8663715b08f41a3aec47cc,443741,1606722,100982616105
160379551,1702653029,1702652675,-354,0xad8663715b08f41a3aec47cc,443742,1569558,100982616105
160379552,1702653029,1702652675,-354,0xad8663715b08f41a3aec47cc,443743,1597944,100982616105
160379553,1702653029,1702652699,-330,0xad8663715b08f41a3aec47cc,443744,1591088,101980893328
160379554,1702653029,1702652699,-330,0xad8663715b08f41a3aec47cc,443745,1563098,101980893328
160379555,1702653029,1702652699,-330,0xad8663715b08f41a3aec47cc,443746,1573504,101980893328
160379556,1702653029,1702652699,-330,0xad8663715b08f41a3aec47cc,443747,1549628,101980893328
160379557,1702653029,1702652699,-330,0xad8663715b08f41a3aec47cc,443748,1568522,101980893328
160379558,1702653029,1702652699,-330,0xad8663715b08f41a3aec47cc,443749,1591994,101980893328
160379559,1702653029,1702652723,-306,0xad8663715b08f41a3aec47cc,443750,1561154,100875685993
160379560,1702653029,1702652723,-306,0xad8663715b08f41a3aec47cc,443751,1566842,100875685993
160379561,1702653029,1702652723,-306,0xad8663715b08f41a3aec47cc,443752,1539470,100875685993
160379562,1702653029,1702652723,-306,0xad8663715b08f41a3aec47cc,443753,1597982,100875685993
160379563,1702653029,1702652723,-306,0xad8663715b08f41a3aec47cc,443754,1587428,100875685993
160379564,1702653029,1702652723,-306,0xad8663715b08f41a3aec47cc,443755,1553596,100875685993
160379565,1702653029,1702652747,-282,0xad8663715b08f41a3aec47cc,443756,1547072,100499019002
160379566,1702653029,1702652747,-282,0xad8663715b08f41a3aec47cc,443757,1595232,100499019002
160379567,1702653029,1702652747,-282,0xad8663715b08f41a3aec47cc,443758,1605912,100499019002
160379568,1702653029,1702652747,-282,0xad8663715b08f41a3aec47cc,443759,1509512,100499019002
160379569,1702653029,1702652747,-282,0xad8663715b08f41a3aec47cc,443760,1407560,100499019002
160379570,1702653029,1702652747,-282,0xad8663715b08f41a3aec47cc,443761,1609000,100499019002
160381088,1702653419,1702652771,-648,0xad8663715b08f41a3aec47cc,443762,1614914,98001495435
160381089,1702653419,1702652771,-648,0xad8663715b08f41a3aec47cc,443763,1613738,98001495435
160381090,1702653419,1702652771,-648,0xad8663715b08f41a3aec47cc,443764,1586588,98001495435
160381091,1702653419,1702652771,-648,0xad8663715b08f41a3aec47cc,443765,1546276,98001495435
160381092,1702653419,1702652771,-648,0xad8663715b08f41a3aec47cc,443766,1471488,98001495435
160381093,1702653419,1702652771,-648,0xad8663715b08f41a3aec47cc,443767,1549772,98001495435
160381094,1702653419,1702652795,-624,0xad8663715b08f41a3aec47cc,443768,1600508,101536294304
160381095,1702653419,1702652795,-624,0xad8663715b08f41a3aec47cc,443769,1560458,101536294304
160381096,1702653419,1702652795,-624,0xad8663715b08f41a3aec47cc,443770,1607010,101536294304
160381097,1702653419,1702652795,-624,0xad8663715b08f41a3aec47cc,443771,1571564,101536294304
160381098,1702653419,1702652795,-624,0xad8663715b08f41a3aec47cc,443772,1597910,101536294304
160381099,1702653419,1702652795,-624,0xad8663715b08f41a3aec47cc,443773,1562104,101536294304
160381100,1702653419,1702652831,-588,0xad8663715b08f41a3aec47cc,443774,1609474,89351508854
160381101,1702653419,1702652831,-588,0xad8663715b08f41a3aec47cc,443775,1562146,89351508854
160381102,1702653419,1702652831,-588,0xad8663715b08f41a3aec47cc,443776,1532052,89351508854
160381103,1702653419,1702652831,-588,0xad8663715b08f41a3aec47cc,443777,1561530,89351508854
160381104,1702653419,1702652831,-588,0xad8663715b08f41a3aec47cc,443778,1577960,89351508854
160381105,1702653419,1702652831,-588,0xad8663715b08f41a3aec47cc,443779,1581268,89351508854
160381106,1702653419,1702652831,-588,0xad8663715b08f41a3aec47cc,443780,1555192,89351508854
160381107,1702653419,1702652855,-564,0xad8663715b08f41a3aec47cc,443781,1574594,96927327399
160381108,1702653419,1702652855,-564,0xad8663715b08f41a3aec47cc,443782,1477848,96927327399
160381109,1702653419,1702652855,-564,0xad8663715b08f41a3aec47cc,443783,1582246,96927327399
160381110,1702653419,1702652855,-564,0xad8663715b08f41a3aec47cc,443784,1567794,96927327399
160381111,1702653419,1702652855,-564,0xad8663715b08f41a3aec47cc,443785,1605266,96927327399
160381112,1702653419,1702652855,-564,0xad8663715b08f41a3aec47cc,443786,1522746,96927327399
160381113,1702653419,1702652879,-540,0xad8663715b08f41a3aec47cc,443787,1584720,93057411358
160381114,1702653419,1702652879,-540,0xad8663715b08f41a3aec47cc,443788,1502368,93057411358
160381115,1702653419,1702652879,-540,0xad8663715b08f41a3aec47cc,443789,1491556,93057411358
160381116,1702653419,1702652879,-540,0xad8663715b08f41a3aec47cc,443790,1475032,93057411358
160381117,1702653419,1702652879,-540,0xad8663715b08f41a3aec47cc,443791,1604776,93057411358
160381118,1702653419,1702652879,-540,0xad8663715b08f41a3aec47cc,443792,1357482,93057411358
160381119,1702653419,1702652879,-540,0xad8663715b08f41a3aec47cc,443793,1485534,93057411358
160381120,1702653419,1702652903,-516,0xad8663715b08f41a3aec47cc,443794,1540498,100425041979
160381121,1702653419,1702652903,-516,0xad8663715b08f41a3aec47cc,443795,1615102,100425041979
160381122,1702653419,1702652903,-516,0xad8663715b08f41a3aec47cc,443796,1551154,100425041979
160381123,1702653419,1702652903,-516,0xad8663715b08f41a3aec47cc,443797,1607708,100425041979
160381124,1702653419,1702652903,-516,0xad8663715b08f41a3aec47cc,443798,1597822,100425041979
160381125,1702653419,1702652903,-516,0xad8663715b08f41a3aec47cc,443799,1390650,100425041979
160381126,1702653419,1702652927,-492,0xad8663715b08f41a3aec47cc,443800,1472468,96302140238
160381127,1702653419,1702652927,-492,0xad8663715b08f41a3aec47cc,443801,1612306,96302140238
160381128,1702653419,1702652927,-492,0xad8663715b08f41a3aec47cc,443802,1560504,96302140238
160381130,1702653419,1702652927,-492,0xad8663715b08f41a3aec47cc,443803,1572012,96302140238
160381131,1702653419,1702652927,-492,0xad8663715b08f41a3aec47cc,443804,1577678,96302140238
160381132,1702653419,1702652927,-492,0xad8663715b08f41a3aec47cc,443805,1562340,96302140238
160381133,1702653419,1702652951,-468,0xad8663715b08f41a3aec47cc,443806,1552682,96510418531
160381134,1702653419,1702652951,-468,0xad8663715b08f41a3aec47cc,443807,1565966,96510418531
160381135,1702653419,1702652951,-468,0xad8663715b08f41a3aec47cc,443808,1601078,96510418531
160381136,1702653419,1702652951,-468,0xad8663715b08f41a3aec47cc,443809,1599728,96510418531
160381137,1702653419,1702652951,-468,0xad8663715b08f41a3aec47cc,443810,1529280,96510418531
160381138,1702653419,1702652951,-468,0xad8663715b08f41a3aec47cc,443811,1596858,96510418531
160381139,1702653419,1702652975,-444,0xad8663715b08f41a3aec47cc,443812,1575940,96903086867
160381140,1702653419,1702652975,-444,0xad8663715b08f41a3aec47cc,443813,1605086,96903086867
160381141,1702653419,1702652975,-444,0xad8663715b08f41a3aec47cc,443814,1562784,96903086867
160381142,1702653419,1702652975,-444,0xad8663715b08f41a3aec47cc,443815,1603814,96903086867
160381143,1702653419,1702652975,-444,0xad8663715b08f41a3aec47cc,443816,1540788,96903086867
160381144,1702653419,1702652975,-444,0xad8663715b08f41a3aec47cc,443817,1600268,96903086867
160381146,1702653419,1702652999,-420,0xad8663715b08f41a3aec47cc,443818,1566700,95681255645
160381147,1702653419,1702652999,-420,0xad8663715b08f41a3aec47cc,443819,1550914,95681255645
160381148,1702653419,1702652999,-420,0xad8663715b08f41a3aec47cc,443820,1581902,95681255645
160381149,1702653419,1702652999,-420,0xad8663715b08f41a3aec47cc,443821,1488646,95681255645
160381150,1702653419,1702652999,-420,0xad8663715b08f41a3aec47cc,443822,1488756,95681255645
160381151,1702653419,1702652999,-420,0xad8663715b08f41a3aec47cc,443823,1604512,95681255645
160381152,1702653419,1702652999,-420,0xad8663715b08f41a3aec47cc,443824,1587082,95681255645
160381153,1702653419,1702653023,-396,0xad8663715b08f41a3aec47cc,443825,1594512,99789765534
160381154,1702653419,1702653023,-396,0xad8663715b08f41a3aec47cc,443826,1518258,99789765534
160381155,1702653419,1702653023,-396,0xad8663715b08f41a3aec47cc,443827,1427014,99789765534
160381156,1702653419,1702653023,-396,0xad8663715b08f41a3aec47cc,443828,1603904,99789765534
160381157,1702653419,1702653023,-396,0xad8663715b08f41a3aec47cc,443829,1578066,99789765534
160381158,1702653419,1702653023,-396,0xad8663715b08f41a3aec47cc,443830,1605160,99789765534
160381159,1702653419,1702653047,-372,0xad8663715b08f41a3aec47cc,443831,1507982,106501210780
160381160,1702653419,1702653047,-372,0xad8663715b08f41a3aec47cc,443832,1534702,106501210780
160381161,1702653419,1702653047,-372,0xad8663715b08f41a3aec47cc,443833,1572488,106501210780
160381162,1702653419,1702653047,-372,0xad8663715b08f41a3aec47cc,443834,1573080,106501210780
160381163,1702653419,1702653047,-372,0xad8663715b08f41a3aec47cc,443835,1572160,106501210780
160381164,1702653419,1702653047,-372,0xad8663715b08f41a3aec47cc,443836,1566898,106501210780
160381167,1702653419,1702653071,-348,0xad8663715b08f41a3aec47cc,443837,1603592,107899579843
160381168,1702653419,1702653071,-348,0xad8663715b08f41a3aec47cc,443838,1544940,107899579843
160381169,1702653419,1702653071,-348,0xad8663715b08f41a3aec47cc,443839,1595498,107899579843
160381170,1702653419,1702653071,-348,0xad8663715b08f41a3aec47cc,443840,1612982,107899579843
160381171,1702653419,1702653071,-348,0xad8663715b08f41a3aec47cc,443841,1570960,107899579843
160381172,1702653419,1702653071,-348,0xad8663715b08f41a3aec47cc,443842,1544564,107899579843
160381173,1702653419,1702653095,-324,0xad8663715b08f41a3aec47cc,443843,1571566,120474749629
160381174,1702653419,1702653095,-324,0xad8663715b08f41a3aec47cc,443844,1575022,120474749629
160381175,1702653419,1702653095,-324,0xad8663715b08f41a3aec47cc,443845,1590898,120474749629
160381176,1702653419,1702653095,-324,0xad8663715b08f41a3aec47cc,443846,1611266,120474749629
160381177,1702653419,1702653095,-324,0xad8663715b08f41a3aec47cc,443847,1598236,120474749629
160381178,1702653419,1702653095,-324,0xad8663715b08f41a3aec47cc,443848,1593594,120474749629
160381179,1702653419,1702653119,-300,0xad8663715b08f41a3aec47cc,443849,1556536,122819880782
160381180,1702653419,1702653119,-300,0xad8663715b08f41a3aec47cc,443850,1583572,122819880782
160381182,1702653419,1702653131,-288,0xad8663715b08f41a3aec47cc,443851,1552902,120185629744
160381184,1702653419,1702653131,-288,0xad8663715b08f41a3aec47cc,443852,1560116,120185629744
160381185,1702653419,1702653131,-288,0xad8663715b08f41a3aec47cc,443853,1587468,120185629744
160381186,1702653419,1702653131,-288,0xad8663715b08f41a3aec47cc,443854,1573328,120185629744
160381187,1702653419,1702653131,-288,0xad8663715b08f41a3aec47cc,443855,1609518,120185629744
160381188,1702653419,1702653131,-288,0xad8663715b08f41a3aec47cc,443856,1557462,120185629744
160382681,1702653794,1702653155,-639,0xad8663715b08f41a3aec47cc,443857,1559912,128107563271
160382682,1702653794,1702653155,-639,0xad8663715b08f41a3aec47cc,443858,1608668,128107563271
160382683,1702653794,1702653155,-639,0xad8663715b08f41a3aec47cc,443859,1569530,128107563271
160382685,1702653794,1702653155,-639,0xad8663715b08f41a3aec47cc,443860,1598388,128107563271
160382686,1702653794,1702653155,-639,0xad8663715b08f41a3aec47cc,443861,1608564,128107563271
160382688,1702653794,1702653179,-615,0xad8663715b08f41a3aec47cc,443862,1587690,127689537522
160382689,1702653794,1702653179,-615,0xad8663715b08f41a3aec47cc,443863,1564938,127689537522
160382690,1702653794,1702653179,-615,0xad8663715b08f41a3aec47cc,443864,1551996,127689537522
160382691,1702653794,1702653179,-615,0xad8663715b08f41a3aec47cc,443865,1540458,127689537522
160382692,1702653794,1702653179,-615,0xad8663715b08f41a3aec47cc,443866,1542756,127689537522
160382693,1702653794,1702653203,-591,0xad8663715b08f41a3aec47cc,443867,1558918,124990160495
160382694,1702653794,1702653203,-591,0xad8663715b08f41a3aec47cc,443868,1550964,124990160495
160382695,1702653794,1702653203,-591,0xad8663715b08f41a3aec47cc,443869,1568796,124990160495
160382696,1702653794,1702653203,-591,0xad8663715b08f41a3aec47cc,443870,1593088,124990160495
160382697,1702653794,1702653203,-591,0xad8663715b08f41a3aec47cc,443871,1465482,124990160495
160382698,1702653794,1702653227,-567,0xad8663715b08f41a3aec47cc,443872,1533760,123473990703
160382699,1702653794,1702653227,-567,0xad8663715b08f41a3aec47cc,443873,1568784,123473990703
160382700,1702653794,1702653227,-567,0xad8663715b08f41a3aec47cc,443874,1575092,123473990703
160382701,1702653794,1702653227,-567,0xad8663715b08f41a3aec47cc,443875,1550670,123473990703
160382702,1702653794,1702653227,-567,0xad8663715b08f41a3aec47cc,443876,1572232,123473990703
160382703,1702653794,1702653227,-567,0xad8663715b08f41a3aec47cc,443877,1562086,123473990703
160382704,1702653794,1702653251,-543,0xad8663715b08f41a3aec47cc,443878,1572882,123044569345
160382705,1702653794,1702653251,-543,0xad8663715b08f41a3aec47cc,443879,1531762,123044569345
160382706,1702653794,1702653251,-543,0xad8663715b08f41a3aec47cc,443880,1549506,123044569345
160382707,1702653794,1702653251,-543,0xad8663715b08f41a3aec47cc,443881,1554304,123044569345
160382708,1702653794,1702653251,-543,0xad8663715b08f41a3aec47cc,443882,1578716,123044569345
160382709,1702653794,1702653251,-543,0xad8663715b08f41a3aec47cc,443883,1571816,123044569345
160382710,1702653794,1702653263,-531,0xad8663715b08f41a3aec47cc,443884,1482124,128173882165
160382711,1702653794,1702653263,-531,0xad8663715b08f41a3aec47cc,443885,1534132,128173882165
160382712,1702653794,1702653275,-519,0xad8663715b08f41a3aec47cc,443886,1585168,129688573813
160382713,1702653794,1702653275,-519,0xad8663715b08f41a3aec47cc,443887,1592720,129688573813
160382714,1702653794,1702653275,-519,0xad8663715b08f41a3aec47cc,443888,1574758,129688573813
160382715,1702653794,1702653275,-519,0xad8663715b08f41a3aec47cc,443889,1561900,129688573813
160382716,1702653794,1702653275,-519,0xad8663715b08f41a3aec47cc,443890,1522944,129688573813
160382717,1702653794,1702653287,-507,0xad8663715b08f41a3aec47cc,443891,1574224,131542792954
160382718,1702653794,1702653287,-507,0xad8663715b08f41a3aec47cc,443892,1550040,131542792954
160382719,1702653794,1702653287,-507,0xad8663715b08f41a3aec47cc,443893,1562042,131542792954
160382720,1702653794,1702653287,-507,0xad8663715b08f41a3aec47cc,443894,1570814,131542792954
160382721,1702653794,1702653287,-507,0xad8663715b08f41a3aec47cc,443895,1599404,131542792954
160382723,1702653794,1702653299,-495,0xad8663715b08f41a3aec47cc,443896,1601832,134627691782
160382724,1702653794,1702653299,-495,0xad8663715b08f41a3aec47cc,443897,1528970,134627691782
160382725,1702653794,1702653299,-495,0xad8663715b08f41a3aec47cc,443898,1605606,134627691782
160382726,1702653794,1702653299,-495,0xad8663715b08f41a3aec47cc,443899,1570790,134627691782
160382727,1702653794,1702653299,-495,0xad8663715b08f41a3aec47cc,443900,1601486,134627691782
160382728,1702653794,1702653323,-471,0xad8663715b08f41a3aec47cc,443901,1533418,134582721484
160382729,1702653794,1702653323,-471,0xad8663715b08f41a3aec47cc,443902,1587536,134582721484
160382730,1702653794,1702653323,-471,0xad8663715b08f41a3aec47cc,443903,1452172,134582721484
160382731,1702653794,1702653323,-471,0xad8663715b08f41a3aec47cc,443904,1546800,134582721484
160382732,1702653794,1702653323,-471,0xad8663715b08f41a3aec47cc,443905,1540498,134582721484
160382734,1702653794,1702653335,-459,0xad8663715b08f41a3aec47cc,443906,1590116,135311304112
160382735,1702653794,1702653335,-459,0xad8663715b08f41a3aec47cc,443907,1569294,135311304112
160382736,1702653794,1702653335,-459,0xad8663715b08f41a3aec47cc,443908,1537224,135311304112
160382737,1702653794,1702653347,-447,0xad8663715b08f41a3aec47cc,443909,1593194,135297902655
160382738,1702653794,1702653395,-399,0xad8663715b08f41a3aec47cc,443910,1583414,120192391597
160382741,1702653794,1702653479,-315,0xad8663715b08f41a3aec47cc,443911,1595022,91495033924
160384183,1702654155,1702653551,-604,0xad8663715b08f41a3aec47cc,443912,1560016,78974837472
160384184,1702654155,1702653551,-604,0xad8663715b08f41a3aec47cc,443913,1558936,78974837472
160384185,1702654155,1702653551,-604,0xad8663715b08f41a3aec47cc,443914,1612526,78974837472
160384187,1702654207,1702653551,-656,0xad8663715b08f41a3aec47cc,443915,1578726,78974837472
160384188,1702654207,1702653551,-656,0xad8663715b08f41a3aec47cc,443916,1500442,78974837472
160384190,1702654235,1702653551,-684,0xad8663715b08f41a3aec47cc,443917,1592090,78974837472
160384191,1702654235,1702653551,-684,0xad8663715b08f41a3aec47cc,443918,1526104,78974837472
160384194,1702654262,1702653563,-699,0xad8663715b08f41a3aec47cc,443919,1591894,88183067912
160384195,1702654262,1702653563,-699,0xad8663715b08f41a3aec47cc,443920,1601276,88183067912
160384196,1702654262,1702653563,-699,0xad8663715b08f41a3aec47cc,443921,1547328,88183067912
160384198,1702654290,1702653563,-727,0xad8663715b08f41a3aec47cc,443922,1591920,88183067912
160384199,1702654290,1702653575,-715,0xad8663715b08f41a3aec47cc,443923,1597034,92118512889
160384201,1702654292,1702653575,-717,0xad8663715b08f41a3aec47cc,443924,1552190,92118512889
160384202,1702654292,1702653575,-717,0xad8663715b08f41a3aec47cc,443925,1597678,92118512889
160384205,1702654320,1702653587,-733,0xad8663715b08f41a3aec47cc,443926,1557596,92584038399
160384206,1702654320,1702653587,-733,0xad8663715b08f41a3aec47cc,443927,1594342,92584038399
160384208,1702654370,1702653587,-783,0xad8663715b08f41a3aec47cc,443928,1520412,92584038399
160384209,1702654370,1702653587,-783,0xad8663715b08f41a3aec47cc,443929,1580756,92584038399
160384211,1702654372,1702653599,-773,0xad8663715b08f41a3aec47cc,443930,1560476,92201418659
160384212,1702654372,1702653599,-773,0xad8663715b08f41a3aec47cc,443931,1581106,92201418659
160384213,1702654372,1702653599,-773,0xad8663715b08f41a3aec47cc,443932,1600348,92201418659
160384215,1702654373,1702653611,-762,0xad8663715b08f41a3aec47cc,443933,1587790,90232167698
160384216,1702654373,1702653611,-762,0xad8663715b08f41a3aec47cc,443934,1596432,90232167698
160384217,1702654373,1702653611,-762,0xad8663715b08f41a3aec47cc,443935,1513208,90232167698
160384219,1702654424,1702653611,-813,0xad8663715b08f41a3aec47cc,443936,1544966,90232167698
160384220,1702654424,1702653623,-801,0xad8663715b08f41a3aec47cc,443937,1608228,98286391745
160384221,1702654424,1702653623,-801,0xad8663715b08f41a3aec47cc,443938,1565480,98286391745
160384223,1702654428,1702653623,-805,0xad8663715b08f41a3aec47cc,443939,1580272,98286391745
160384224,1702654428,1702653623,-805,0xad8663715b08f41a3aec47cc,443940,1610492,98286391745
160384226,1702654477,1702653623,-854,0xad8663715b08f41a3aec47cc,443941,1611940,98286391745
160384227,1702654477,1702653623,-854,0xad8663715b08f41a3aec47cc,443942,1608808,98286391745
160384228,1702654477,1702653635,-842,0xad8663715b08f41a3aec47cc,443943,1507252,103073592627
160384230,1702654479,1702653635,-844,0xad8663715b08f41a3aec47cc,443944,1599154,103073592627
160384231,1702654479,1702653635,-844,0xad8663715b08f41a3aec47cc,443945,1534572,103073592627
160384232,1702654479,1702653635,-844,0xad8663715b08f41a3aec47cc,443946,1529624,103073592627
160384234,1702654481,1702653635,-846,0xad8663715b08f41a3aec47cc,443947,1590964,103073592627
160384235,1702654481,1702653635,-846,0xad8663715b08f41a3aec47cc,443948,1580860,103073592627
160384236,1702654481,1702653659,-822,0xad8663715b08f41a3aec47cc,443949,1594494,98702881446
160384238,1702654483,1702653659,-824,0xad8663715b08f41a3aec47cc,443950,1602622,98702881446
160384239,1702654483,1702653659,-824,0xad8663715b08f41a3aec47cc,443951,1576918,98702881446
160384240,1702654483,1702653659,-824,0xad8663715b08f41a3aec47cc,443952,1550068,98702881446
160384242,1702654486,1702653659,-827,0xad8663715b08f41a3aec47cc,443953,1608388,98702881446
160384243,1702654486,1702653659,-827,0xad8663715b08f41a3aec47cc,443954,1608580,98702881446
160384246,1702654489,1702653683,-806,0xad8663715b08f41a3aec47cc,443955,1579416,99470713112
160384248,1702654490,1702653683,-807,0xad8663715b08f41a3aec47cc,443956,1611252,99470713112
160384249,1702654490,1702653683,-807,0xad8663715b08f41a3aec47cc,443957,1535710,99470713112
160384250,1702654490,1702653683,-807,0xad8663715b08f41a3aec47cc,443958,1579668,99470713112
160384252,1702654493,1702653683,-810,0xad8663715b08f41a3aec47cc,443959,1533860,99470713112
160384253,1702654493,1702653683,-810,0xad8663715b08f41a3aec47cc,443960,1598740,99470713112
160384254,1702654493,1702653695,-798,0xad8663715b08f41a3aec47cc,443961,1544448,103549334800
160384256,1702654494,1702653695,-799,0xad8663715b08f41a3aec47cc,443962,1567580,103549334800
160384257,1702654494,1702653695,-799,0xad8663715b08f41a3aec47cc,443963,1505532,103549334800
160384259,1702654496,1702653695,-801,0xad8663715b08f41a3aec47cc,443964,1612680,103549334800
160384260,1702654496,1702653707,-789,0xad8663715b08f41a3aec47cc,443965,1531488,101991089031
160384262,1702654497,1702653707,-790,0xad8663715b08f41a3aec47cc,443966,1518466,101991089031
160384263,1702654497,1702653707,-790,0xad8663715b08f41a3aec47cc,443967,1605044,101991089031
160384265,1702654500,1702653707,-793,0xad8663715b08f41a3aec47cc,443968,1576862,101991089031
160384266,1702654500,1702653707,-793,0xad8663715b08f41a3aec47cc,443969,1587204,101991089031
160384268,1702654501,1702653707,-794,0xad8663715b08f41a3aec47cc,443970,1567756,101991089031
160384269,1702654501,1702653731,-770,0xad8663715b08f41a3aec47cc,443971,1582668,106922802770
160384271,1702654502,1702653731,-771,0xad8663715b08f41a3aec47cc,443972,1592792,106922802770
160384272,1702654502,1702653731,-771,0xad8663715b08f41a3aec47cc,443973,1553330,106922802770
160384274,1702654506,1702653731,-775,0xad8663715b08f41a3aec47cc,443974,1586350,106922802770
160384275,1702654506,1702653731,-775,0xad8663715b08f41a3aec47cc,443975,1594326,106922802770
160384276,1702654506,1702653731,-775,0xad8663715b08f41a3aec47cc,443976,1545064,106922802770
160384278,1702654533,1702653755,-778,0xad8663715b08f41a3aec47cc,443977,1590892,108183175615
160384279,1702654533,1702653755,-778,0xad8663715b08f41a3aec47cc,443978,1556484,108183175615
160384280,1702654533,1702653755,-778,0xad8663715b08f41a3aec47cc,443979,1586836,108183175615
160384282,1702654534,1702653755,-779,0xad8663715b08f41a3aec47cc,443980,1551612,108183175615
160384283,1702654534,1702653755,-779,0xad8663715b08f41a3aec47cc,443981,1549762,108183175615
160384285,1702654535,1702653755,-780,0xad8663715b08f41a3aec47cc,443982,1540958,108183175615
160384289,1702654540,1702653767,-773,0xad8663715b08f41a3aec47cc,443983,1604074,110371195667
160384291,1702654541,1702653779,-762,0xad8663715b08f41a3aec47cc,443984,1611316,106804862278
160384292,1702654541,1702653779,-762,0xad8663715b08f41a3aec47cc,443985,1581136,106804862278
160384293,1702654541,1702653779,-762,0xad8663715b08f41a3aec47cc,443986,1560910,106804862278
160384295,1702654542,1702653779,-763,0xad8663715b08f41a3aec47cc,443987,1586238,106804862278
160384296,1702654542,1702653779,-763,0xad8663715b08f41a3aec47cc,443988,1582720,106804862278
160384298,1702654568,1702653779,-789,0xad8663715b08f41a3aec47cc,443989,1574964,106804862278
160384299,1702654568,1702653803,-765,0xad8663715b08f41a3aec47cc,443990,1607530,104453676243
160384301,1702654569,1702653803,-766,0xad8663715b08f41a3aec47cc,443991,1585366,104453676243
160384302,1702654569,1702653803,-766,0xad8663715b08f41a3aec47cc,443992,1604456,104453676243
160384304,1702654596,1702653803,-793,0xad8663715b08f41a3aec47cc,443993,1588160,104453676243
160384305,1702654596,1702653803,-793,0xad8663715b08f41a3aec47cc,443994,1553972,104453676243
160384307,1702654597,1702653803,-794,0xad8663715b08f41a3aec47cc,443995,1599436,104453676243
160384308,1702654597,1702653827,-770,0xad8663715b08f41a3aec47cc,443996,1597704,102221747041
160384310,1702654598,1702653827,-771,0xad8663715b08f41a3aec47cc,443997,1558004,102221747041
160384311,1702654598,1702653827,-771,0xad8663715b08f41a3aec47cc,443998,1490976,102221747041
160384313,1702654599,1702653827,-772,0xad8663715b08f41a3aec47cc,443999,1559526,102221747041
160384314,1702654599,1702653827,-772,0xad8663715b08f41a3aec47cc,444000,1556482,102221747041
160384315,1702654599,1702653827,-772,0xad8663715b08f41a3aec47cc,444001,1491556,102221747041
160384318,1702654601,1702653839,-762,0xad8663715b08f41a3aec47cc,444002,1601914,104777119495
160384319,1702654601,1702653839,-762,0xad8663715b08f41a3aec47cc,444003,1571056,104777119495
160384321,1702654602,1702653839,-763,0xad8663715b08f41a3aec47cc,444004,1525976,104777119495
160384322,1702654602,1702653839,-763,0xad8663715b08f41a3aec47cc,444005,1612384,104777119495
160384324,1702654603,1702653839,-764,0xad8663715b08f41a3aec47cc,444006,1598730,104777119495
160384325,1702654603,1702653839,-764,0xad8663715b08f41a3aec47cc,444007,1599936,104777119495
160384327,1702654604,1702653851,-753,0xad8663715b08f41a3aec47cc,444008,1600884,110205327806
160384328,1702654604,1702653851,-753,0xad8663715b08f41a3aec47cc,444009,1606868,110205327806
160384330,1702654605,1702653851,-754,0xad8663715b08f41a3aec47cc,444010,1590696,110205327806
160384331,1702654605,1702653851,-754,0xad8663715b08f41a3aec47cc,444011,1603174,110205327806
160384332,1702654605,1702653851,-754,0xad8663715b08f41a3aec47cc,444012,1567044,110205327806
160384334,1702654606,1702653911,-695,0xad8663715b08f41a3aec47cc,444013,1593848,95549835640
160384359,1702654619,1702653935,-684,0xad8663715b08f41a3aec47cc,444014,1548092,91881085266
160384360,1702654619,1702653935,-684,0xad8663715b08f41a3aec47cc,444015,1591838,91881085266
160384361,1702654619,1702653935,-684,0xad8663715b08f41a3aec47cc,444016,1461860,91881085266
160384363,1702654619,1702653935,-684,0xad8663715b08f41a3aec47cc,444017,1585890,91881085266
160384364,1702654619,1702653935,-684,0xad8663715b08f41a3aec47cc,444018,1603952,91881085266
160384365,1702654619,1702653935,-684,0xad8663715b08f41a3aec47cc,444019,1532682,91881085266
160384367,1702654621,1702653935,-686,0xad8663715b08f41a3aec47cc,444020,1555108,91881085266
160384368,1702654621,1702653959,-662,0xad8663715b08f41a3aec47cc,444021,1552882,96957560286
160384369,1702654621,1702653959,-662,0xad8663715b08f41a3aec47cc,444022,1596184,96957560286
160384371,1702654623,1702653959,-664,0xad8663715b08f41a3aec47cc,444023,1590126,96957560286
160384372,1702654623,1702653959,-664,0xad8663715b08f41a3aec47cc,444024,1609240,96957560286
160384373,1702654623,1702653959,-664,0xad8663715b08f41a3aec47cc,444025,1603816,96957560286
160384375,1702654626,1702653959,-667,0xad8663715b08f41a3aec47cc,444026,1598976,96957560286
160384376,1702654626,1702653971,-655,0xad8663715b08f41a3aec47cc,444027,1610732,99901894758
160384377,1702654626,1702653971,-655,0xad8663715b08f41a3aec47cc,444028,1599320,99901894758
160384379,1702654627,1702653971,-656,0xad8663715b08f41a3aec47cc,444029,1562180,99901894758
160384380,1702654627,1702653971,-656,0xad8663715b08f41a3aec47cc,444030,1550972,99901894758
160384381,1702654627,1702653971,-656,0xad8663715b08f41a3aec47cc,444031,1568264,99901894758
160384383,1702654629,1702653971,-658,0xad8663715b08f41a3aec47cc,444032,1543288,99901894758
160384384,1702654629,1702653983,-646,0xad8663715b08f41a3aec47cc,444033,1591246,105437264770
160384386,1702654629,1702653983,-646,0xad8663715b08f41a3aec47cc,444034,1579150,105437264770
160384387,1702654629,1702653983,-646,0xad8663715b08f41a3aec47cc,444035,1572282,105437264770
160384388,1702654629,1702653983,-646,0xad8663715b08f41a3aec47cc,444036,1606182,105437264770
160384390,1702654631,1702653983,-648,0xad8663715b08f41a3aec47cc,444037,1589262,105437264770
160384391,1702654631,1702653983,-648,0xad8663715b08f41a3aec47cc,444038,1576134,105437264770
160384393,1702654680,1702653995,-685,0xad8663715b08f41a3aec47cc,444039,1531014,110439171707
160384394,1702654680,1702653995,-685,0xad8663715b08f41a3aec47cc,444040,1518626,110439171707
160384395,1702654680,1702653995,-685,0xad8663715b08f41a3aec47cc,444041,1609288,110439171707
160384397,1702654681,1702653995,-686,0xad8663715b08f41a3aec47cc,444042,1571622,110439171707
160384398,1702654681,1702653995,-686,0xad8663715b08f41a3aec47cc,444043,1592094,110439171707
160384399,1702654681,1702653995,-686,0xad8663715b08f41a3aec47cc,444044,1563132,110439171707
160384401,1702654683,1702654019,-664,0xad8663715b08f41a3aec47cc,444045,1599056,106749426747
160384402,1702654683,1702654019,-664,0xad8663715b08f41a3aec47cc,444046,1531840,106749426747
160384403,1702654683,1702654019,-664,0xad8663715b08f41a3aec47cc,444047,1547584,106749426747
160384405,1702654685,1702654019,-666,0xad8663715b08f41a3aec47cc,444048,1500712,106749426747
160384406,1702654685,1702654019,-666,0xad8663715b08f41a3aec47cc,444049,1566458,106749426747
160384408,1702654686,1702654019,-667,0xad8663715b08f41a3aec47cc,444050,1535956,106749426747
160384409,1702654686,1702654043,-643,0xad8663715b08f41a3aec47cc,444051,1609256,106499097421
160384410,1702654686,1702654043,-643,0xad8663715b08f41a3aec47cc,444052,1550536,106499097421
160384412,1702654688,1702654043,-645,0xad8663715b08f41a3aec47cc,444053,1558204,106499097421
160384413,1702654688,1702654043,-645,0xad8663715b08f41a3aec47cc,444054,1565946,106499097421
160384415,1702654692,1702654043,-649,0xad8663715b08f41a3aec47cc,444055,1583596,106499097421
160384416,1702654692,1702654043,-649,0xad8663715b08f41a3aec47cc,444056,1594440,106499097421
160384417,1702654692,1702654055,-637,0xad8663715b08f41a3aec47cc,444057,1577124,109123907013
160384418,1702654692,1702654055,-637,0xad8663715b08f41a3aec47cc,444058,1607756,109123907013
160384419,1702654692,1702654055,-637,0xad8663715b08f41a3aec47cc,444059,1547388,109123907013
160384421,1702654694,1702654055,-639,0xad8663715b08f41a3aec47cc,444060,1586584,109123907013
160384422,1702654694,1702654055,-639,0xad8663715b08f41a3aec47cc,444061,1548860,109123907013
160384423,1702654694,1702654055,-639,0xad8663715b08f41a3aec47cc,444062,1485074,109123907013
160384425,1702654694,1702654067,-627,0xad8663715b08f41a3aec47cc,444063,1606438,112505372259
160384427,1702654697,1702654067,-630,0xad8663715b08f41a3aec47cc,444064,1521598,112505372259
160384428,1702654697,1702654067,-630,0xad8663715b08f41a3aec47cc,444065,1580026,112505372259
160384429,1702654697,1702654067,-630,0xad8663715b08f41a3aec47cc,444066,1557422,112505372259
160384430,1702654697,1702654067,-630,0xad8663715b08f41a3aec47cc,444067,1607472,112505372259
160384431,1702654697,1702654067,-630,0xad8663715b08f41a3aec47cc,444068,1539590,112505372259
160384432,1702654697,1702654091,-606,0xad8663715b08f41a3aec47cc,444069,1599376,109928990537
160384434,1702654700,1702654091,-609,0xad8663715b08f41a3aec47cc,444070,1563040,109928990537
160384435,1702654700,1702654091,-609,0xad8663715b08f41a3aec47cc,444071,1594850,109928990537
160384436,1702654700,1702654091,-609,0xad8663715b08f41a3aec47cc,444072,1549182,109928990537
160384438,1702654701,1702654091,-610,0xad8663715b08f41a3aec47cc,444073,1580676,109928990537
160384439,1702654701,1702654091,-610,0xad8663715b08f41a3aec47cc,444074,1564794,109928990537
160384440,1702654701,1702654115,-586,0xad8663715b08f41a3aec47cc,444075,1509438,112251216200
160384442,1702654751,1702654115,-636,0xad8663715b08f41a3aec47cc,444076,1594686,112251216200
160384443,1702654751,1702654115,-636,0xad8663715b08f41a3aec47cc,444077,1584528,112251216200
160384445,1702654752,1702654115,-637,0xad8663715b08f41a3aec47cc,444078,1573694,112251216200
160384446,1702654752,1702654115,-637,0xad8663715b08f41a3aec47cc,444079,1614422,112251216200
160384448,1702654753,1702654115,-638,0xad8663715b08f41a3aec47cc,444080,1549552,112251216200
160384449,1702654753,1702654127,-626,0xad8663715b08f41a3aec47cc,444081,1601624,117186260473
160384450,1702654753,1702654127,-626,0xad8663715b08f41a3aec47cc,444082,1593980,117186260473
160384451,1702654753,1702654127,-626,0xad8663715b08f41a3aec47cc,444083,1573920,117186260473
160384453,1702654755,1702654127,-628,0xad8663715b08f41a3aec47cc,444084,1592096,117186260473
160384454,1702654755,1702654127,-628,0xad8663715b08f41a3aec47cc,444085,1590170,117186260473
160384455,1702654755,1702654127,-628,0xad8663715b08f41a3aec47cc,444086,1584528,117186260473
160384457,1702654755,1702654139,-616,0xad8663715b08f41a3aec47cc,444087,1531210,118426102827
160384458,1702654755,1702654139,-616,0xad8663715b08f41a3aec47cc,444088,1600352,118426102827
160384459,1702654755,1702654139,-616,0xad8663715b08f41a3aec47cc,444089,1570956,118426102827
160384460,1702654755,1702654139,-616,0xad8663715b08f41a3aec47cc,444090,1570972,118426102827
160384461,1702654755,1702654139,-616,0xad8663715b08f41a3aec47cc,444091,1528218,118426102827
160384463,1702654758,1702654139,-619,0xad8663715b08f41a3aec47cc,444092,1535776,118426102827
160384464,1702654758,1702654151,-607,0xad8663715b08f41a3aec47cc,444093,1606184,119768635407
160384465,1702654758,1702654151,-607,0xad8663715b08f41a3aec47cc,444094,1585878,119768635407
160384466,1702654758,1702654151,-607,0xad8663715b08f41a3aec47cc,444095,1527628,119768635407
160384467,1702654758,1702654151,-607,0xad8663715b08f41a3aec47cc,444096,1530522,119768635407
160384468,1702654758,1702654151,-607,0xad8663715b08f41a3aec47cc,444097,1577196,119768635407
160384469,1702654758,1702654151,-607,0xad8663715b08f41a3aec47cc,444098,1514766,119768635407
160384471,1702654760,1702654163,-597,0xad8663715b08f41a3aec47cc,444099,1492840,125620428131
160384472,1702654760,1702654163,-597,0xad8663715b08f41a3aec47cc,444100,1510758,125620428131
160384473,1702654760,1702654163,-597,0xad8663715b08f41a3aec47cc,444101,1550016,125620428131
160384474,1702654760,1702654163,-597,0xad8663715b08f41a3aec47cc,444102,1595342,125620428131
160384475,1702654760,1702654163,-597,0xad8663715b08f41a3aec47cc,444103,1521094,125620428131
160384476,1702654760,1702654175,-585,0xad8663715b08f41a3aec47cc,444104,1596944,128835632740
160384477,1702654760,1702654175,-585,0xad8663715b08f41a3aec47cc,444105,1555690,128835632740
160384478,1702654760,1702654175,-585,0xad8663715b08f41a3aec47cc,444106,1543782,128835632740
160384479,1702654760,1702654199,-561,0xad8663715b08f41a3aec47cc,444107,1543522,118973744370
160384481,1702654760,1702654295,-465,0xad8663715b08f41a3aec47cc,444108,1541838,95726746751
160384521,1702654949,1702654319,-630,0xad8663715b08f41a3aec47cc,444109,1557336,92646971332
160384522,1702654949,1702654319,-630,0xad8663715b08f41a3aec47cc,444110,1522740,92646971332
160384523,1702654949,1702654319,-630,0xad8663715b08f41a3aec47cc,444111,1587636,92646971332
160384524,1702654949,1702654319,-630,0xad8663715b08f41a3aec47cc,444112,1558328,92646971332
160384525,1702654949,1702654319,-630,0xad8663715b08f41a3aec47cc,444113,1543968,92646971332
160384526,1702654949,1702654319,-630,0xad8663715b08f41a3aec47cc,444114,1569816,92646971332
160384527,1702654949,1702654319,-630,0xad8663715b08f41a3aec47cc,444115,1556358,92646971332
160384528,1702654949,1702654331,-618,0xad8663715b08f41a3aec47cc,444116,1574802,99665779262
160384529,1702654949,1702654331,-618,0xad8663715b08f41a3aec47cc,444117,1552556,99665779262
160384530,1702654949,1702654331,-618,0xad8663715b08f41a3aec47cc,444118,1522512,99665779262
160384531,1702654949,1702654331,-618,0xad8663715b08f41a3aec47cc,444119,1561406,99665779262
160384532,1702654949,1702654331,-618,0xad8663715b08f41a3aec47cc,444120,1571892,99665779262
160384533,1702654949,1702654331,-618,0xad8663715b08f41a3aec47cc,444121,1439480,99665779262
160384534,1702654949,1702654343,-606,0xad8663715b08f41a3aec47cc,444122,1531630,105594704613
160384535,1702654949,1702654343,-606,0xad8663715b08f41a3aec47cc,444123,1597856,105594704613
160384536,1702654949,1702654343,-606,0xad8663715b08f41a3aec47cc,444124,1581874,105594704613
160384537,1702654949,1702654343,-606,0xad8663715b08f41a3aec47cc,444125,1588314,105594704613
160384538,1702654949,1702654343,-606,0xad8663715b08f41a3aec47cc,444126,1610256,105594704613
160384539,1702654949,1702654343,-606,0xad8663715b08f41a3aec47cc,444127,1599484,105594704613
160384541,1702655007,1702654355,-652,0xad8663715b08f41a3aec47cc,444128,1550238,110818345296
160384542,1702655007,1702654355,-652,0xad8663715b08f41a3aec47cc,444129,1535582,110818345296
160384544,1702655009,1702654355,-654,0xad8663715b08f41a3aec47cc,444130,1589416,110818345296
160384545,1702655009,1702654355,-654,0xad8663715b08f41a3aec47cc,444131,1563978,110818345296
160384546,1702655009,1702654355,-654,0xad8663715b08f41a3aec47cc,444132,1540394,110818345296
160384547,1702655009,1702654355,-654,0xad8663715b08f41a3aec47cc,444133,1576844,110818345296
160384549,1702655012,1702654379,-633,0xad8663715b08f41a3aec47cc,444134,1541582,107399471895
160384550,1702655012,1702654379,-633,0xad8663715b08f41a3aec47cc,444135,1547712,107399471895
160384552,1702655060,1702654379,-681,0xad8663715b08f41a3aec47cc,444136,1533026,107399471895
160384553,1702655060,1702654379,-681,0xad8663715b08f41a3aec47cc,444137,1610432,107399471895
160384555,1702655061,1702654379,-682,0xad8663715b08f41a3aec47cc,444138,1597322,107399471895
160384556,1702655061,1702654379,-682,0xad8663715b08f41a3aec47cc,444139,1572912,107399471895
160384557,1702655061,1702654403,-658,0xad8663715b08f41a3aec47cc,444140,1582492,108614063149
160384559,1702655064,1702654403,-661,0xad8663715b08f41a3aec47cc,444141,1576780,108614063149
160384560,1702655064,1702654403,-661,0xad8663715b08f41a3aec47cc,444142,1581164,108614063149
160384562,1702655067,1702654403,-664,0xad8663715b08f41a3aec47cc,444143,1603820,108614063149
160384563,1702655067,1702654403,-664,0xad8663715b08f41a3aec47cc,444144,1520568,108614063149
160384564,1702655067,1702654403,-664,0xad8663715b08f41a3aec47cc,444145,1594914,108614063149
160384567,1702655071,1702654415,-656,0xad8663715b08f41a3aec47cc,444146,1539948,114854417168
160384568,1702655071,1702654415,-656,0xad8663715b08f41a3aec47cc,444147,1610566,114854417168
160384569,1702655071,1702654415,-656,0xad8663715b08f41a3aec47cc,444148,1547020,114854417168
160384571,1702655073,1702654415,-658,0xad8663715b08f41a3aec47cc,444149,1593142,114854417168
160384572,1702655073,1702654415,-658,0xad8663715b08f41a3aec47cc,444150,1455206,114854417168
160384573,1702655073,1702654415,-658,0xad8663715b08f41a3aec47cc,444151,1588166,114854417168
160384574,1702655073,1702654427,-646,0xad8663715b08f41a3aec47cc,444152,1580454,118449586305
160384575,1702655073,1702654427,-646,0xad8663715b08f41a3aec47cc,444153,1568602,118449586305
160384576,1702655073,1702654427,-646,0xad8663715b08f41a3aec47cc,444154,1546306,118449586305
160384577,1702655073,1702654427,-646,0xad8663715b08f41a3aec47cc,444155,1542722,118449586305
160384579,1702655122,1702654427,-695,0xad8663715b08f41a3aec47cc,444156,1563084,118449586305
160384580,1702655122,1702654427,-695,0xad8663715b08f41a3aec47cc,444157,1574240,118449586305
160384581,1702655122,1702654439,-683,0xad8663715b08f41a3aec47cc,444158,1585798,119908819073
160384583,1702655124,1702654439,-685,0xad8663715b08f41a3aec47cc,444159,1560050,119908819073
160384584,1702655124,1702654439,-685,0xad8663715b08f41a3aec47cc,444160,1606304,119908819073
160384585,1702655124,1702654439,-685,0xad8663715b08f41a3aec47cc,444161,1580848,119908819073
160384586,1702655124,1702654439,-685,0xad8663715b08f41a3aec47cc,444162,1502112,119908819073
160384587,1702655124,1702654559,-565,0xad8663715b08f41a3aec47cc,444163,1569788,95082806295
160384613,1702655340,1702654703,-637,0xad8663715b08f41a3aec47cc,444164,1528812,75832954912
160384614,1702655340,1702654703,-637,0xad8663715b08f41a3aec47cc,444165,1610838,75832954912
160384615,1702655340,1702654703,-637,0xad8663715b08f41a3aec47cc,444166,1604664,75832954912
160384617,1702655373,1702654703,-670,0xad8663715b08f41a3aec47cc,444167,1608332,75832954912
160384618,1702655373,1702654703,-670,0xad8663715b08f41a3aec47cc,444168,1551668,75832954912
160384620,1702655377,1702654703,-674,0xad8663715b08f41a3aec47cc,444169,1549774,75832954912
160384621,1702655377,1702654703,-674,0xad8663715b08f41a3aec47cc,444170,1593176,75832954912
160384623,1702655379,1702654703,-676,0xad8663715b08f41a3aec47cc,444171,1509956,75832954912
160384624,1702655379,1702654727,-652,0xad8663715b08f41a3aec47cc,444172,1582596,83800713015
160384625,1702655379,1702654727,-652,0xad8663715b08f41a3aec47cc,444173,1603582,83800713015
160384626,1702655379,1702654727,-652,0xad8663715b08f41a3aec47cc,444174,1498786,83800713015
160384628,1702655431,1702654727,-704,0xad8663715b08f41a3aec47cc,444175,1599356,83800713015
160384629,1702655431,1702654727,-704,0xad8663715b08f41a3aec47cc,444176,1608762,83800713015
160384631,1702655434,1702654727,-707,0xad8663715b08f41a3aec47cc,444177,1614152,83800713015
160384632,1702655434,1702654727,-707,0xad8663715b08f41a3aec47cc,444178,1578484,83800713015
160384633,1702655434,1702654739,-695,0xad8663715b08f41a3aec47cc,444179,1568032,87312344881
160384634,1702655434,1702654739,-695,0xad8663715b08f41a3aec47cc,444180,1600700,87312344881
160384635,1702655434,1702654739,-695,0xad8663715b08f41a3aec47cc,444181,1527484,87312344881
160384637,1702655489,1702654739,-750,0xad8663715b08f41a3aec47cc,444182,1587900,87312344881
160384638,1702655489,1702654739,-750,0xad8663715b08f41a3aec47cc,444183,1520122,87312344881
160384639,1702655489,1702654739,-750,0xad8663715b08f41a3aec47cc,444184,1578270,87312344881
160384640,1702655489,1702654739,-750,0xad8663715b08f41a3aec47cc,444185,1604502,87312344881
160384642,1702655492,1702654763,-729,0xad8663715b08f41a3aec47cc,444186,1592650,93563460571
160384643,1702655492,1702654763,-729,0xad8663715b08f41a3aec47cc,444187,1589916,93563460571
160384645,1702655545,1702654763,-782,0xad8663715b08f41a3aec47cc,444188,1554696,93563460571
160384646,1702655545,1702654763,-782,0xad8663715b08f41a3aec47cc,444189,1574374,93563460571
160384648,1702655550,1702654763,-787,0xad8663715b08f41a3aec47cc,444190,1552196,93563460571
160384649,1702655550,1702654763,-787,0xad8663715b08f41a3aec47cc,444191,1561440,93563460571
160384650,1702655550,1702654787,-763,0xad8663715b08f41a3aec47cc,444192,1529426,102506316878
160384651,1702655550,1702654787,-763,0xad8663715b08f41a3aec47cc,444193,1520894,102506316878
160384652,1702655550,1702654787,-763,0xad8663715b08f41a3aec47cc,444194,1554192,102506316878
160384653,1702655550,1702654787,-763,0xad8663715b08f41a3aec47cc,444195,1529840,102506316878
160384654,1702655550,1702654787,-763,0xad8663715b08f41a3aec47cc,444196,1529976,102506316878
160384655,1702655550,1702654787,-763,0xad8663715b08f41a3aec47cc,444197,1591278,102506316878
160384656,1702655550,1702654799,-751,0xad8663715b08f41a3aec47cc,444198,1588142,106051784010
160384657,1702655550,1702654799,-751,0xad8663715b08f41a3aec47cc,444199,1547456,106051784010
160384658,1702655550,1702654799,-751,0xad8663715b08f41a3aec47cc,444200,1616514,106051784010
160384659,1702655550,1702654799,-751,0xad8663715b08f41a3aec47cc,444201,1604636,106051784010
160384660,1702655550,1702654799,-751,0xad8663715b08f41a3aec47cc,444202,1573774,106051784010
160384662,1702655559,1702654799,-760,0xad8663715b08f41a3aec47cc,444203,1517786,106051784010
160384663,1702655559,1702654811,-748,0xad8663715b08f41a3aec47cc,444204,1532742,109941021968
160384664,1702655559,1702654811,-748,0xad8663715b08f41a3aec47cc,444205,1518922,109941021968
160384665,1702655559,1702654811,-748,0xad8663715b08f41a3aec47cc,444206,1526400,109941021968
160384666,1702655559,1702654811,-748,0xad8663715b08f41a3aec47cc,444207,1561894,109941021968
160384667,1702655559,1702654811,-748,0xad8663715b08f41a3aec47cc,444208,1564748,109941021968
160384668,1702655559,1702654811,-748,0xad8663715b08f41a3aec47cc,444209,1564196,109941021968
160384669,1702655559,1702654823,-736,0xad8663715b08f41a3aec47cc,444210,1614170,114615747204
160384670,1702655559,1702654823,-736,0xad8663715b08f41a3aec47cc,444211,1537502,114615747204
160384671,1702655559,1702654823,-736,0xad8663715b08f41a3aec47cc,444212,1614480,114615747204
160384672,1702655559,1702654823,-736,0xad8663715b08f41a3aec47cc,444213,1507202,114615747204
160384673,1702655559,1702654823,-736,0xad8663715b08f41a3aec47cc,444214,1597008,114615747204
160384674,1702655559,1702654823,-736,0xad8663715b08f41a3aec47cc,444215,1590258,114615747204
160384677,1702655559,1702654835,-724,0xad8663715b08f41a3aec47cc,444216,1531184,117560409134
160384678,1702655559,1702654835,-724,0xad8663715b08f41a3aec47cc,444217,1572744,117560409134
160384679,1702655559,1702654835,-724,0xad8663715b08f41a3aec47cc,444218,1549180,117560409134
160384680,1702655559,1702654835,-724,0xad8663715b08f41a3aec47cc,444219,1548518,117560409134
160384681,1702655559,1702654835,-724,0xad8663715b08f41a3aec47cc,444220,1488132,117560409134
160384682,1702655559,1702654835,-724,0xad8663715b08f41a3aec47cc,444221,1545554,117560409134
160384683,1702655559,1702654847,-712,0xad8663715b08f41a3aec47cc,444222,1607454,119939048078
160384684,1702655559,1702654847,-712,0xad8663715b08f41a3aec47cc,444223,1540790,119939048078
160384685,1702655559,1702654847,-712,0xad8663715b08f41a3aec47cc,444224,1587320,119939048078
160384686,1702655559,1702654847,-712,0xad8663715b08f41a3aec47cc,444225,1607242,119939048078
160384687,1702655559,1702654847,-712,0xad8663715b08f41a3aec47cc,444226,1570394,119939048078
160384688,1702655559,1702654847,-712,0xad8663715b08f41a3aec47cc,444227,1488734,119939048078
160384689,1702655559,1702654871,-688,0xad8663715b08f41a3aec47cc,444228,1508360,113575555208
160384690,1702655559,1702654871,-688,0xad8663715b08f41a3aec47cc,444229,1527022,113575555208
160384691,1702655559,1702654871,-688,0xad8663715b08f41a3aec47cc,444230,1504150,113575555208
160384692,1702655559,1702654871,-688,0xad8663715b08f41a3aec47cc,444231,1559712,113575555208
160384693,1702655559,1702654871,-688,0xad8663715b08f41a3aec47cc,444232,1498422,113575555208
160384694,1702655559,1702654871,-688,0xad8663715b08f41a3aec47cc,444233,1509228,113575555208
160384695,1702655559,1702654883,-676,0xad8663715b08f41a3aec47cc,444234,1539062,121394021657
160384696,1702655559,1702654883,-676,0xad8663715b08f41a3aec47cc,444235,1612262,121394021657
160384697,1702655559,1702654883,-676,0xad8663715b08f41a3aec47cc,444236,1516032,121394021657
160384698,1702655559,1702654883,-676,0xad8663715b08f41a3aec47cc,444237,1503110,121394021657
160384699,1702655559,1702654883,-676,0xad8663715b08f41a3aec47cc,444238,1431136,121394021657
160384700,1702655559,1702654883,-676,0xad8663715b08f41a3aec47cc,444239,1527190,121394021657
160384702,1702655559,1702654895,-664,0xad8663715b08f41a3aec47cc,444240,1611326,125392862124
160384703,1702655559,1702654895,-664,0xad8663715b08f41a3aec47cc,444241,1611518,125392862124
160384704,1702655559,1702654895,-664,0xad8663715b08f41a3aec47cc,444242,1524258,125392862124
160384705,1702655559,1702654895,-664,0xad8663715b08f41a3aec47cc,444243,1595094,125392862124
160384706,1702655559,1702654895,-664,0xad8663715b08f41a3aec47cc,444244,1584564,125392862124
160384707,1702655559,1702654907,-652,0xad8663715b08f41a3aec47cc,444245,1560258,124440381079
160384708,1702655559,1702654907,-652,0xad8663715b08f41a3aec47cc,444246,1610442,124440381079
160384709,1702655559,1702654907,-652,0xad8663715b08f41a3aec47cc,444247,1526634,124440381079
160384710,1702655559,1702654907,-652,0xad8663715b08f41a3aec47cc,444248,1579884,124440381079
160384711,1702655559,1702654907,-652,0xad8663715b08f41a3aec47cc,444249,1571752,124440381079
160384712,1702655559,1702654919,-640,0xad8663715b08f41a3aec47cc,444250,1525630,127751511478
160384713,1702655559,1702654919,-640,0xad8663715b08f41a3aec47cc,444251,1575366,127751511478
160384714,1702655559,1702654919,-640,0xad8663715b08f41a3aec47cc,444252,1569570,127751511478
160384715,1702655559,1702654919,-640,0xad8663715b08f41a3aec47cc,444253,1527772,127751511478
160384716,1702655559,1702654919,-640,0xad8663715b08f41a3aec47cc,444254,1484244,127751511478
160384717,1702655559,1702654943,-616,0xad8663715b08f41a3aec47cc,444255,1586702,118742120478
160384718,1702655559,1702654943,-616,0xad8663715b08f41a3aec47cc,444256,1517930,118742120478
160384719,1702655559,1702654943,-616,0xad8663715b08f41a3aec47cc,444257,1577378,118742120478
160384720,1702655559,1702654943,-616,0xad8663715b08f41a3aec47cc,444258,1603026,118742120478
160384721,1702655559,1702654943,-616,0xad8663715b08f41a3aec47cc,444259,1570242,118742120478
160384722,1702655559,1702654943,-616,0xad8663715b08f41a3aec47cc,444260,1571670,118742120478
160384723,1702655559,1702654955,-604,0xad8663715b08f41a3aec47cc,444261,1595698,125553616760
160384724,1702655559,1702654955,-604,0xad8663715b08f41a3aec47cc,444262,1597070,125553616760
160384725,1702655559,1702654955,-604,0xad8663715b08f41a3aec47cc,444263,1469900,125553616760
160384726,1702655559,1702654967,-592,0xad8663715b08f41a3aec47cc,444264,1608850,123129626321
160384727,1702655559,1702655051,-508,0xad8663715b08f41a3aec47cc,444265,1516884,93749554647
160384729,1702655669,1702655087,-582,0xad8663715b08f41a3aec47cc,444266,1563406,84981266482
160384730,1702655669,1702655087,-582,0xad8663715b08f41a3aec47cc,444267,1526294,84981266482
160384731,1702655669,1702655087,-582,0xad8663715b08f41a3aec47cc,444268,1555856,84981266482
160384732,1702655669,1702655087,-582,0xad8663715b08f41a3aec47cc,444269,1568850,84981266482
160384733,1702655669,1702655087,-582,0xad8663715b08f41a3aec47cc,444270,1481426,84981266482
160384734,1702655669,1702655087,-582,0xad8663715b08f41a3aec47cc,444271,1558660,84981266482
160384735,1702655669,1702655087,-582,0xad8663715b08f41a3aec47cc,444272,1500968,84981266482
160384737,1702655669,1702655135,-534,0xad8663715b08f41a3aec47cc,444273,1557854,83740201480
160384738,1702655669,1702655135,-534,0xad8663715b08f41a3aec47cc,444274,1534632,83740201480
160384739,1702655669,1702655135,-534,0xad8663715b08f41a3aec47cc,444275,1607744,83740201480
160384740,1702655669,1702655135,-534,0xad8663715b08f41a3aec47cc,444276,1561326,83740201480
160384741,1702655669,1702655135,-534,0xad8663715b08f41a3aec47cc,444277,1516578,83740201480
160384742,1702655669,1702655135,-534,0xad8663715b08f41a3aec47cc,444278,1605120,83740201480
160384743,1702655669,1702655135,-534,0xad8663715b08f41a3aec47cc,444279,1505708,83740201480
160384744,1702655669,1702655147,-522,0xad8663715b08f41a3aec47cc,444280,1541038,94202292623
160384745,1702655669,1702655147,-522,0xad8663715b08f41a3aec47cc,444281,1565640,94202292623
160384746,1702655669,1702655147,-522,0xad8663715b08f41a3aec47cc,444282,1461322,94202292623
160384748,1702655730,1702655147,-583,0xad8663715b08f41a3aec47cc,444283,1543738,94202292623
160384749,1702655730,1702655147,-583,0xad8663715b08f41a3aec47cc,444284,1530042,94202292623
160384750,1702655730,1702655147,-583,0xad8663715b08f41a3aec47cc,444285,1559342,94202292623
160384751,1702655730,1702655147,-583,0xad8663715b08f41a3aec47cc,444286,1502906,94202292623
160384752,1702655730,1702655159,-571,0xad8663715b08f41a3aec47cc,444287,1576698,105974700535
160384753,1702655730,1702655159,-571,0xad8663715b08f41a3aec47cc,444288,1525208,105974700535
160384754,1702655730,1702655159,-571,0xad8663715b08f41a3aec47cc,444289,1543982,105974700535
160384755,1702655730,1702655159,-571,0xad8663715b08f41a3aec47cc,444290,1475890,105974700535
160384756,1702655730,1702655159,-571,0xad8663715b08f41a3aec47cc,444291,1597052,105974700535
160384757,1702655730,1702655159,-571,0xad8663715b08f41a3aec47cc,444292,1550598,105974700535
160384758,1702655730,1702655171,-559,0xad8663715b08f41a3aec47cc,444293,1602942,111968718792
160384759,1702655730,1702655171,-559,0xad8663715b08f41a3aec47cc,444294,1571832,111968718792
160384760,1702655730,1702655171,-559,0xad8663715b08f41a3aec47cc,444295,1608852,111968718792
160384761,1702655730,1702655171,-559,0xad8663715b08f41a3aec47cc,444296,1583138,111968718792
160384762,1702655730,1702655171,-559,0xad8663715b08f41a3aec47cc,444297,1566392,111968718792
160384763,1702655730,1702655171,-559,0xad8663715b08f41a3aec47cc,444298,1584666,111968718792
160384764,1702655730,1702655195,-535,0xad8663715b08f41a3aec47cc,444299,1544990,106617188857
160384765,1702655730,1702655195,-535,0xad8663715b08f41a3aec47cc,444300,1611498,106617188857
160384766,1702655730,1702655195,-535,0xad8663715b08f41a3aec47cc,444301,1556398,106617188857
160384767,1702655730,1702655195,-535,0xad8663715b08f41a3aec47cc,444302,1557972,106617188857
160384768,1702655730,1702655195,-535,0xad8663715b08f41a3aec47cc,444303,1551348,106617188857
160384769,1702655730,1702655195,-535,0xad8663715b08f41a3aec47cc,444304,1574764,106617188857
160384770,1702655730,1702655207,-523,0xad8663715b08f41a3aec47cc,444305,1603756,116998368599
160384771,1702655730,1702655207,-523,0xad8663715b08f41a3aec47cc,444306,1529734,116998368599
160384772,1702655730,1702655207,-523,0xad8663715b08f41a3aec47cc,444307,1529598,116998368599
160384773,1702655730,1702655207,-523,0xad8663715b08f41a3aec47cc,444308,1544582,116998368599
160384774,1702655730,1702655207,-523,0xad8663715b08f41a3aec47cc,444309,1614900,116998368599
160384775,1702655730,1702655207,-523,0xad8663715b08f41a3aec47cc,444310,1485838,116998368599
160384776,1702655730,1702655219,-511,0xad8663715b08f41a3aec47cc,444311,1521360,119667150136
160384777,1702655730,1702655219,-511,0xad8663715b08f41a3aec47cc,444312,1536098,119667150136
160384778,1702655730,1702655219,-511,0xad8663715b08f41a3aec47cc,444313,1506948,119667150136
160384779,1702655730,1702655219,-511,0xad8663715b08f41a3aec47cc,444314,1540332,119667150136
160384780,1702655730,1702655219,-511,0xad8663715b08f41a3aec47cc,444315,1575690,119667150136
160384781,1702655730,1702655219,-511,0xad8663715b08f41a3aec47cc,444316,1580484,119667150136
160384782,1702655730,1702655231,-499,0xad8663715b08f41a3aec47cc,444317,1535566,122398143975
160384783,1702655730,1702655231,-499,0xad8663715b08f41a3aec47cc,444318,1521570,122398143975
160384784,1702655730,1702655231,-499,0xad8663715b08f41a3aec47cc,444319,1569142,122398143975
160384785,1702655730,1702655231,-499,0xad8663715b08f41a3aec47cc,444320,1536532,122398143975
160384786,1702655730,1702655231,-499,0xad8663715b08f41a3aec47cc,444321,1535856,122398143975
160384787,1702655730,1702655231,-499,0xad8663715b08f41a3aec47cc,444322,1513154,122398143975
160384788,1702655730,1702655243,-487,0xad8663715b08f41a3aec47cc,444323,1513714,126329095006
160384789,1702655730,1702655243,-487,0xad8663715b08f41a3aec47cc,444324,1543776,126329095006
160384790,1702655730,1702655243,-487,0xad8663715b08f41a3aec47cc,444325,1570738,126329095006
160384791,1702655730,1702655243,-487,0xad8663715b08f41a3aec47cc,444326,1555994,126329095006
160384792,1702655730,1702655243,-487,0xad8663715b08f41a3aec47cc,444327,1515858,126329095006
160384793,1702655730,1702655255,-475,0xad8663715b08f41a3aec47cc,444328,1508196,124141003495
160384794,1702655730,1702655255,-475,0xad8663715b08f41a3aec47cc,444329,1507138,124141003495
160384795,1702655730,1702655255,-475,0xad8663715b08f41a3aec47cc,444330,1609312,124141003495
160384796,1702655730,1702655255,-475,0xad8663715b08f41a3aec47cc,444331,1573304,124141003495
160384797,1702655730,1702655255,-475,0xad8663715b08f41a3aec47cc,444332,1593800,124141003495
160384798,1702655730,1702655279,-451,0xad8663715b08f41a3aec47cc,444333,1578568,114574120065
160384799,1702655730,1702655279,-451,0xad8663715b08f41a3aec47cc,444334,1503840,114574120065
160384800,1702655730,1702655279,-451,0xad8663715b08f41a3aec47cc,444335,1585210,114574120065
160384801,1702655730,1702655279,-451,0xad8663715b08f41a3aec47cc,444336,1612604,114574120065
160384802,1702655730,1702655279,-451,0xad8663715b08f41a3aec47cc,444337,1584584,114574120065
160384803,1702655730,1702655279,-451,0xad8663715b08f41a3aec47cc,444338,1519598,114574120065
160384804,1702655730,1702655291,-439,0xad8663715b08f41a3aec47cc,444339,1610082,118538796131
160384805,1702655730,1702655291,-439,0xad8663715b08f41a3aec47cc,444340,1539368,118538796131
160384806,1702655730,1702655291,-439,0xad8663715b08f41a3aec47cc,444341,1553786,118538796131
160384807,1702655730,1702655291,-439,0xad8663715b08f41a3aec47cc,444342,1548596,118538796131
160384808,1702655730,1702655291,-439,0xad8663715b08f41a3aec47cc,444343,1518508,118538796131
160384809,1702655730,1702655291,-439,0xad8663715b08f41a3aec47cc,444344,1541282,118538796131
160384810,1702655730,1702655303,-427,0xad8663715b08f41a3aec47cc,444345,1524672,122111690778
160384811,1702655730,1702655303,-427,0xad8663715b08f41a3aec47cc,444346,1477896,122111690778
160384812,1702655730,1702655303,-427,0xad8663715b08f41a3aec47cc,444347,1613804,122111690778
160384814,1702656055,1702655303,-752,0xad8663715b08f41a3aec47cc,444348,1545960,122111690778
160384815,1702656055,1702655303,-752,0xad8663715b08f41a3aec47cc,444349,1425566,122111690778
160384816,1702656055,1702655303,-752,0xad8663715b08f41a3aec47cc,444350,1474788,122111690778
160384817,1702656055,1702655339,-716,0xad8663715b08f41a3aec47cc,444351,1522958,115753421468
160384818,1702656055,1702655339,-716,0xad8663715b08f41a3aec47cc,444352,1577400,115753421468
160384819,1702656055,1702655339,-716,0xad8663715b08f41a3aec47cc,444353,1589884,115753421468
160384820,1702656055,1702655339,-716,0xad8663715b08f41a3aec47cc,444354,1555846,115753421468
160384821,1702656055,1702655339,-716,0xad8663715b08f41a3aec47cc,444355,1517230,115753421468
160384822,1702656055,1702655339,-716,0xad8663715b08f41a3aec47cc,444356,1555634,115753421468
160384823,1702656055,1702655351,-704,0xad8663715b08f41a3aec47cc,444357,1532450,130081664537
160384824,1702656055,1702655351,-704,0xad8663715b08f41a3aec47cc,444358,1529716,130081664537
160384825,1702656055,1702655375,-680,0xad8663715b08f41a3aec47cc,444359,1508966,123006784787
160384826,1702656055,1702655471,-584,0xad8663715b08f41a3aec47cc,444360,1556490,96784786130
160384827,1702656055,1702655471,-584,0xad8663715b08f41a3aec47cc,444361,1545986,96784786130
160384828,1702656055,1702655471,-584,0xad8663715b08f41a3aec47cc,444362,1540458,96784786130
160384829,1702656055,1702655471,-584,0xad8663715b08f41a3aec47cc,444363,1491058,96784786130
160384830,1702656055,1702655471,-584,0xad8663715b08f41a3aec47cc,444364,1547184,96784786130
160384831,1702656055,1702655471,-584,0xad8663715b08f41a3aec47cc,444365,1497968,96784786130
160384832,1702656055,1702655495,-560,0xad8663715b08f41a3aec47cc,444366,1505916,97637835752
160384833,1702656055,1702655495,-560,0xad8663715b08f41a3aec47cc,444367,1568260,97637835752
160384834,1702656055,1702655495,-560,0xad8663715b08f41a3aec47cc,444368,1499976,97637835752
160384835,1702656055,1702655495,-560,0xad8663715b08f41a3aec47cc,444369,1610086,97637835752
160384836,1702656055,1702655495,-560,0xad8663715b08f41a3aec47cc,444370,1554880,97637835752
160384837,1702656055,1702655495,-560,0xad8663715b08f41a3aec47cc,444371,1567478,97637835752
160384838,1702656055,1702655507,-548,0xad8663715b08f41a3aec47cc,444372,1528346,99987177014
160384839,1702656055,1702655507,-548,0xad8663715b08f41a3aec47cc,444373,1587998,99987177014
160384840,1702656055,1702655507,-548,0xad8663715b08f41a3aec47cc,444374,1606020,99987177014
160384841,1702656055,1702655507,-548,0xad8663715b08f41a3aec47cc,444375,1532284,99987177014
160384842,1702656055,1702655507,-548,0xad8663715b08f41a3aec47cc,444376,1597844,99987177014
160384843,1702656055,1702655507,-548,0xad8663715b08f41a3aec47cc,444377,1603624,99987177014
160384844,1702656055,1702655519,-536,0xad8663715b08f41a3aec47cc,444378,1607092,102268734412
160384845,1702656055,1702655519,-536,0xad8663715b08f41a3aec47cc,444379,1504090,102268734412
160384846,1702656055,1702655519,-536,0xad8663715b08f41a3aec47cc,444380,1599202,102268734412
160384847,1702656055,1702655519,-536,0xad8663715b08f41a3aec47cc,444381,1535506,102268734412
160384848,1702656055,1702655519,-536,0xad8663715b08f41a3aec47cc,444382,1525084,102268734412
160384849,1702656055,1702655519,-536,0xad8663715b08f41a3aec47cc,444383,1610082,102268734412
160384850,1702656055,1702655543,-512,0xad8663715b08f41a3aec47cc,444384,1511986,102084218590
160384851,1702656055,1702655543,-512,0xad8663715b08f41a3aec47cc,444385,1512418,102084218590
160384852,1702656055,1702655543,-512,0xad8663715b08f41a3aec47cc,444386,1589560,102084218590
160384853,1702656055,1702655543,-512,0xad8663715b08f41a3aec47cc,444387,1591450,102084218590
160384854,1702656055,1702655543,-512,0xad8663715b08f41a3aec47cc,444388,1541792,102084218590
160384855,1702656055,1702655543,-512,0xad8663715b08f41a3aec47cc,444389,1575486,102084218590
160384856,1702656055,1702655555,-500,0xad8663715b08f41a3aec47cc,444390,1519372,106807832330
160384857,1702656055,1702655567,-488,0xad8663715b08f41a3aec47cc,444391,1509914,102704508609
160384858,1702656055,1702655567,-488,0xad8663715b08f41a3aec47cc,444392,1487910,102704508609
160384859,1702656055,1702655567,-488,0xad8663715b08f41a3aec47cc,444393,1568848,102704508609
160384860,1702656055,1702655567,-488,0xad8663715b08f41a3aec47cc,444394,1579670,102704508609
160384861,1702656055,1702655567,-488,0xad8663715b08f41a3aec47cc,444395,1601076,102704508609
160384862,1702656055,1702655567,-488,0xad8663715b08f41a3aec47cc,444396,1525980,102704508609
160384863,1702656055,1702655579,-476,0xad8663715b08f41a3aec47cc,444397,1611618,104526403572
160384864,1702656055,1702655579,-476,0xad8663715b08f41a3aec47cc,444398,1606698,104526403572
160384865,1702656055,1702655579,-476,0xad8663715b08f41a3aec47cc,444399,1584502,104526403572
160384866,1702656055,1702655579,-476,0xad8663715b08f41a3aec47cc,444400,1562946,104526403572
160384867,1702656055,1702655579,-476,0xad8663715b08f41a3aec47cc,444401,1612576,104526403572
160384868,1702656055,1702655579,-476,0xad8663715b08f41a3aec47cc,444402,1592500,104526403572
160384869,1702656055,1702655591,-464,0xad8663715b08f41a3aec47cc,444403,1543574,108311653066
160384870,1702656055,1702655591,-464,0xad8663715b08f41a3aec47cc,444404,1515264,108311653066
160384871,1702656055,1702655615,-440,0xad8663715b08f41a3aec47cc,444405,1515104,99141872512
160384872,1702656055,1702655615,-440,0xad8663715b08f41a3aec47cc,444406,1456498,99141872512
160384873,1702656055,1702655615,-440,0xad8663715b08f41a3aec47cc,444407,1570714,99141872512
160384874,1702656055,1702655615,-440,0xad8663715b08f41a3aec47cc,444408,1493620,99141872512
160384875,1702656055,1702655615,-440,0xad8663715b08f41a3aec47cc,444409,1518628,99141872512
160384876,1702656055,1702655615,-440,0xad8663715b08f41a3aec47cc,444410,1540784,99141872512
160384878,1702656055,1702655639,-416,0xad8663715b08f41a3aec47cc,444411,1375186,96588403063
160384879,1702656055,1702655639,-416,0xad8663715b08f41a3aec47cc,444412,1519984,96588403063
160384880,1702656055,1702655639,-416,0xad8663715b08f41a3aec47cc,444413,1488630,96588403063
160384881,1702656055,1702655639,-416,0xad8663715b08f41a3aec47cc,444414,1525350,96588403063
160384882,1702656055,1702655675,-380,0xad8663715b08f41a3aec47cc,444415,1472684,92546463913
160384886,1702656055,1702655807,-248,0xad8663715b08f41a3aec47cc,444416,1599706,74801690857
160384888,1702656399,1702655855,-544,0xad8663715b08f41a3aec47cc,444417,1545740,73221976141
160384889,1702656399,1702655855,-544,0xad8663715b08f41a3aec47cc,444418,1596886,73221976141
160384890,1702656399,1702655855,-544,0xad8663715b08f41a3aec47cc,444419,1548318,73221976141
160384891,1702656399,1702655855,-544,0xad8663715b08f41a3aec47cc,444420,1514830,73221976141
160384892,1702656399,1702655855,-544,0xad8663715b08f41a3aec47cc,444421,1512016,73221976141
160384893,1702656399,1702655855,-544,0xad8663715b08f41a3aec47cc,444422,1558302,73221976141
160384894,1702656399,1702655855,-544,0xad8663715b08f41a3aec47cc,444423,1585834,73221976141
160384895,1702656399,1702655855,-544,0xad8663715b08f41a3aec47cc,444424,1560298,73221976141
160384896,1702656399,1702655891,-508,0xad8663715b08f41a3aec47cc,444425,1510398,66769254556
160384897,1702656399,1702655891,-508,0xad8663715b08f41a3aec47cc,444426,1584074,66769254556
160384898,1702656399,1702655891,-508,0xad8663715b08f41a3aec47cc,444427,1492962,66769254556
160384899,1702656399,1702655903,-496,0xad8663715b08f41a3aec47cc,444428,1576694,75098528769
160384900,1702656399,1702655903,-496,0xad8663715b08f41a3aec47cc,444429,1499998,75098528769
160384901,1702656399,1702655903,-496,0xad8663715b08f41a3aec47cc,444430,1521098,75098528769
160384902,1702656399,1702655903,-496,0xad8663715b08f41a3aec47cc,444431,1522616,75098528769
160384903,1702656399,1702655903,-496,0xad8663715b08f41a3aec47cc,444432,1523202,75098528769
160384904,1702656399,1702655915,-484,0xad8663715b08f41a3aec47cc,444433,1497872,76722123289
160384905,1702656399,1702655915,-484,0xad8663715b08f41a3aec47cc,444434,1566306,76722123289
160384906,1702656399,1702655915,-484,0xad8663715b08f41a3aec47cc,444435,1604596,76722123289
160384907,1702656399,1702655915,-484,0xad8663715b08f41a3aec47cc,444436,1583128,76722123289
160384908,1702656399,1702655915,-484,0xad8663715b08f41a3aec47cc,444437,1548810,76722123289
160384909,1702656399,1702655915,-484,0xad8663715b08f41a3aec47cc,444438,1584790,76722123289
160384910,1702656399,1702655915,-484,0xad8663715b08f41a3aec47cc,444439,1541506,76722123289
160384911,1702656399,1702655927,-472,0xad8663715b08f41a3aec47cc,444440,1522782,84565798694
160384912,1702656399,1702655927,-472,0xad8663715b08f41a3aec47cc,444441,1602888,84565798694
160384913,1702656399,1702655927,-472,0xad8663715b08f41a3aec47cc,444442,1555436,84565798694
160384914,1702656399,1702655939,-460,0xad8663715b08f41a3aec47cc,444443,1542470,88426691811
160384915,1702656399,1702655939,-460,0xad8663715b08f41a3aec47cc,444444,1590978,88426691811
160384916,1702656399,1702655939,-460,0xad8663715b08f41a3aec47cc,444445,1575762,88426691811
160384917,1702656399,1702655939,-460,0xad8663715b08f41a3aec47cc,444446,1487604,88426691811
160384918,1702656399,1702655951,-448,0xad8663715b08f41a3aec47cc,444447,1606080,89534382766
160384919,1702656399,1702655951,-448,0xad8663715b08f41a3aec47cc,444448,1527810,89534382766
160384920,1702656399,1702655951,-448,0xad8663715b08f41a3aec47cc,444449,1537528,89534382766
160384921,1702656399,1702655963,-436,0xad8663715b08f41a3aec47cc,444450,1592298,90445959177
160384922,1702656399,1702655963,-436,0xad8663715b08f41a3aec47cc,444451,1561440,90445959177
160384923,1702656399,1702655963,-436,0xad8663715b08f41a3aec47cc,444452,1519618,90445959177
160384924,1702656399,1702655963,-436,0xad8663715b08f41a3aec47cc,444453,1532594,90445959177
160384925,1702656399,1702655975,-424,0xad8663715b08f41a3aec47cc,444454,1603966,92390439517
160384926,1702656399,1702655975,-424,0xad8663715b08f41a3aec47cc,444455,1542584,92390439517
160384927,1702656399,1702655975,-424,0xad8663715b08f41a3aec47cc,444456,1567994,92390439517
160384928,1702656399,1702655975,-424,0xad8663715b08f41a3aec47cc,444457,1597450,92390439517
160384929,1702656399,1702655975,-424,0xad8663715b08f41a3aec47cc,444458,1520396,92390439517
160384930,1702656399,1702655975,-424,0xad8663715b08f41a3aec47cc,444459,1545384,92390439517
160384931,1702656399,1702655975,-424,0xad8663715b08f41a3aec47cc,444460,1606758,92390439517
160384933,1702656399,1702655999,-400,0xad8663715b08f41a3aec47cc,444461,1518738,90876031899
160384934,1702656399,1702655999,-400,0xad8663715b08f41a3aec47cc,444462,1596820,90876031899
160384935,1702656399,1702655999,-400,0xad8663715b08f41a3aec47cc,444463,1568608,90876031899
160384936,1702656399,1702655999,-400,0xad8663715b08f41a3aec47cc,444464,1566746,90876031899
160384937,1702656399,1702655999,-400,0xad8663715b08f41a3aec47cc,444465,1527834,90876031899
160384938,1702656399,1702655999,-400,0xad8663715b08f41a3aec47cc,444466,1607072,90876031899
160384939,1702656399,1702655999,-400,0xad8663715b08f41a3aec47cc,444467,1545934,90876031899
160384940,1702656399,1702656023,-376,0xad8663715b08f41a3aec47cc,444468,1576214,93286092213
160384941,1702656399,1702656023,-376,0xad8663715b08f41a3aec47cc,444469,1515610,93286092213
160384942,1702656399,1702656023,-376,0xad8663715b08f41a3aec47cc,444470,1532902,93286092213
160384943,1702656399,1702656023,-376,0xad8663715b08f41a3aec47cc,444471,1566326,93286092213
160384944,1702656399,1702656023,-376,0xad8663715b08f41a3aec47cc,444472,1511546,93286092213
160384945,1702656399,1702656023,-376,0xad8663715b08f41a3aec47cc,444473,1592050,93286092213
160384946,1702656399,1702656023,-376,0xad8663715b08f41a3aec47cc,444474,1570860,93286092213
160384948,1702656399,1702656047,-352,0xad8663715b08f41a3aec47cc,444475,1545674,96421712287
160384949,1702656399,1702656047,-352,0xad8663715b08f41a3aec47cc,444476,1544272,96421712287
160384950,1702656399,1702656047,-352,0xad8663715b08f41a3aec47cc,444477,1515058,96421712287
160384951,1702656399,1702656047,-352,0xad8663715b08f41a3aec47cc,444478,1609240,96421712287
160384952,1702656399,1702656047,-352,0xad8663715b08f41a3aec47cc,444479,1519266,96421712287
160384953,1702656399,1702656047,-352,0xad8663715b08f41a3aec47cc,444480,1604390,96421712287
160384954,1702656399,1702656071,-328,0xad8663715b08f41a3aec47cc,444481,1500206,98728598713
160384955,1702656399,1702656071,-328,0xad8663715b08f41a3aec47cc,444482,1569752,98728598713
160384956,1702656399,1702656071,-328,0xad8663715b08f41a3aec47cc,444483,1543454,98728598713
160384957,1702656399,1702656071,-328,0xad8663715b08f41a3aec47cc,444484,1457130,98728598713
160384958,1702656399,1702656071,-328,0xad8663715b08f41a3aec47cc,444485,1513838,98728598713
160384959,1702656399,1702656071,-328,0xad8663715b08f41a3aec47cc,444486,1537562,98728598713
160384960,1702656399,1702656095,-304,0xad8663715b08f41a3aec47cc,444487,1528852,98655404964
160384961,1702656399,1702656095,-304,0xad8663715b08f41a3aec47cc,444488,1550322,98655404964
160384962,1702656399,1702656095,-304,0xad8663715b08f41a3aec47cc,444489,1522358,98655404964
160384963,1702656399,1702656095,-304,0xad8663715b08f41a3aec47cc,444490,1553312,98655404964
160384964,1702656399,1702656095,-304,0xad8663715b08f41a3aec47cc,444491,1526832,98655404964
160384965,1702656399,1702656095,-304,0xad8663715b08f41a3aec47cc,444492,1574444,98655404964
160384966,1702656399,1702656131,-268,0xad8663715b08f41a3aec47cc,444493,1533156,92422650063
160384967,1702656399,1702656131,-268,0xad8663715b08f41a3aec47cc,444494,1525934,92422650063
160384968,1702656399,1702656131,-268,0xad8663715b08f41a3aec47cc,444495,1614260,92422650063
160384969,1702656399,1702656131,-268,0xad8663715b08f41a3aec47cc,444496,1591100,92422650063
160384970,1702656399,1702656131,-268,0xad8663715b08f41a3aec47cc,444497,1477796,92422650063
160384971,1702656399,1702656143,-256,0xad8663715b08f41a3aec47cc,444498,1495064,103827398670
160384972,1702656399,1702656155,-244,0xad8663715b08f41a3aec47cc,444499,1498138,102595011575
160384973,1702656399,1702656167,-232,0xad8663715b08f41a3aec47cc,444500,1582266,99599674976
160384974,1702656399,1702656167,-232,0xad8663715b08f41a3aec47cc,444501,1542892,99599674976
160384975,1702656399,1702656167,-232,0xad8663715b08f41a3aec47cc,444502,1530514,99599674976
160384976,1702656399,1702656167,-232,0xad8663715b08f41a3aec47cc,444503,1605316,99599674976
160384977,1702656399,1702656167,-232,0xad8663715b08f41a3aec47cc,444504,1525288,99599674976
160384978,1702656399,1702656179,-220,0xad8663715b08f41a3aec47cc,444505,1580960,107971667585
160384980,1702656399,1702656191,-208,0xad8663715b08f41a3aec47cc,444506,1552292,103589865997
160384981,1702656399,1702656191,-208,0xad8663715b08f41a3aec47cc,444507,1549776,103589865997
160384982,1702656399,1702656191,-208,0xad8663715b08f41a3aec47cc,444508,1607442,103589865997
160384983,1702656399,1702656191,-208,0xad8663715b08f41a3aec47cc,444509,1580348,103589865997
160384984,1702656399,1702656191,-208,0xad8663715b08f41a3aec47cc,444510,1572062,103589865997
160384985,1702656399,1702656203,-196,0xad8663715b08f41a3aec47cc,444511,1516444,110122131587
160384986,1702656399,1702656215,-184,0xad8663715b08f41a3aec47cc,444512,1517210,106542944820
160384987,1702656399,1702656215,-184,0xad8663715b08f41a3aec47cc,444513,1585072,106542944820
160384988,1702656399,1702656215,-184,0xad8663715b08f41a3aec47cc,444514,1599160,106542944820
160384989,1702656399,1702656215,-184,0xad8663715b08f41a3aec47cc,444515,1561074,106542944820
160384990,1702656399,1702656215,-184,0xad8663715b08f41a3aec47cc,444516,1516536,106542944820
160384992,1702656784,1702656239,-545,0xad8663715b08f41a3aec47cc,444517,1499518,105708340442
160384993,1702656784,1702656239,-545,0xad8663715b08f41a3aec47cc,444518,1595400,105708340442
160384994,1702656784,1702656239,-545,0xad8663715b08f41a3aec47cc,444519,1499372,105708340442
160384995,1702656784,1702656239,-545,0xad8663715b08f41a3aec47cc,444520,1610164,105708340442
160384996,1702656784,1702656239,-545,0xad8663715b08f41a3aec47cc,444521,1487238,105708340442
160384997,1702656784,1702656239,-545,0xad8663715b08f41a3aec47cc,444522,1570752,105708340442
160384998,1702656784,1702656263,-521,0xad8663715b08f41a3aec47cc,444523,1604922,108335251390
160384999,1702656784,1702656263,-521,0xad8663715b08f41a3aec47cc,444524,1535246,108335251390
160385000,1702656784,1702656263,-521,0xad8663715b08f41a3aec47cc,444525,1590824,108335251390
160385001,1702656784,1702656263,-521,0xad8663715b08f41a3aec47cc,444526,1535996,108335251390
160385002,1702656784,1702656263,-521,0xad8663715b08f41a3aec47cc,444527,1576684,108335251390
160385003,1702656784,1702656263,-521,0xad8663715b08f41a3aec47cc,444528,1608526,108335251390
160385004,1702656784,1702656287,-497,0xad8663715b08f41a3aec47cc,444529,1569500,108753852764
160385005,1702656784,1702656287,-497,0xad8663715b08f41a3aec47cc,444530,1602258,108753852764
160385006,1702656784,1702656287,-497,0xad8663715b08f41a3aec47cc,444531,1578676,108753852764
160385007,1702656784,1702656287,-497,0xad8663715b08f41a3aec47cc,444532,1602834,108753852764
160385008,1702656784,1702656287,-497,0xad8663715b08f41a3aec47cc,444533,1554022,108753852764
160385009,1702656784,1702656287,-497,0xad8663715b08f41a3aec47cc,444534,1567234,108753852764
160385010,1702656784,1702656311,-473,0xad8663715b08f41a3aec47cc,444535,1613028,108168227318
160385011,1702656784,1702656311,-473,0xad8663715b08f41a3aec47cc,444536,1564772,108168227318
160385012,1702656784,1702656311,-473,0xad8663715b08f41a3aec47cc,444537,1529390,108168227318
160385013,1702656784,1702656311,-473,0xad8663715b08f41a3aec47cc,444538,1563574,108168227318
160385014,1702656784,1702656311,-473,0xad8663715b08f41a3aec47cc,444539,1516738,108168227318
160385015,1702656784,1702656311,-473,0xad8663715b08f41a3aec47cc,444540,1561022,108168227318
160385016,1702656784,1702656335,-449,0xad8663715b08f41a3aec47cc,444541,1540844,107582388249
160385017,1702656784,1702656335,-449,0xad8663715b08f41a3aec47cc,444542,1514418,107582388249
160385018,1702656784,1702656335,-449,0xad8663715b08f41a3aec47cc,444543,1588152,107582388249
160385019,1702656784,1702656335,-449,0xad8663715b08f41a3aec47cc,444544,1488842,107582388249
160385020,1702656784,1702656335,-449,0xad8663715b08f41a3aec47cc,444545,1556768,107582388249
160385021,1702656784,1702656335,-449,0xad8663715b08f41a3aec47cc,444546,1559544,107582388249
160385023,1702656784,1702656359,-425,0xad8663715b08f41a3aec47cc,444547,1477750,109804997258
160385024,1702656784,1702656359,-425,0xad8663715b08f41a3aec47cc,444548,1602728,109804997258
160385025,1702656784,1702656359,-425,0xad8663715b08f41a3aec47cc,444549,1526300,109804997258
160385026,1702656784,1702656359,-425,0xad8663715b08f41a3aec47cc,444550,1540790,109804997258
160385027,1702656784,1702656359,-425,0xad8663715b08f41a3aec47cc,444551,1510630,109804997258
160385028,1702656784,1702656359,-425,0xad8663715b08f41a3aec47cc,444552,1540626,109804997258
160385029,1702656784,1702656383,-401,0xad8663715b08f41a3aec47cc,444553,1571084,108988448650
160385030,1702656784,1702656383,-401,0xad8663715b08f41a3aec47cc,444554,1600434,108988448650
160385031,1702656784,1702656383,-401,0xad8663715b08f41a3aec47cc,444555,1518376,108988448650
160385032,1702656784,1702656383,-401,0xad8663715b08f41a3aec47cc,444556,1544164,108988448650
160385033,1702656784,1702656383,-401,0xad8663715b08f41a3aec47cc,444557,1520894,108988448650
160385034,1702656784,1702656383,-401,0xad8663715b08f41a3aec47cc,444558,1480030,108988448650
160385035,1702656784,1702656407,-377,0xad8663715b08f41a3aec47cc,444559,1533826,109508200086
160385036,1702656784,1702656407,-377,0xad8663715b08f41a3aec47cc,444560,1544166,109508200086
160385037,1702656784,1702656407,-377,0xad8663715b08f41a3aec47cc,444561,1542480,109508200086
160385038,1702656784,1702656407,-377,0xad8663715b08f41a3aec47cc,444562,1570546,109508200086
160385039,1702656784,1702656407,-377,0xad8663715b08f41a3aec47cc,444563,1582314,109508200086
160385040,1702656784,1702656407,-377,0xad8663715b08f41a3aec47cc,444564,1570190,109508200086
160385041,1702656784,1702656443,-341,0xad8663715b08f41a3aec47cc,444565,1599252,102203664397
160385042,1702656784,1702656443,-341,0xad8663715b08f41a3aec47cc,444566,1571776,102203664397
160385043,1702656784,1702656443,-341,0xad8663715b08f41a3aec47cc,444567,1519516,102203664397
160385044,1702656784,1702656443,-341,0xad8663715b08f41a3aec47cc,444568,1596622,102203664397
160385045,1702656784,1702656443,-341,0xad8663715b08f41a3aec47cc,444569,1535860,102203664397
160385046,1702656784,1702656443,-341,0xad8663715b08f41a3aec47cc,444570,1579828,102203664397
160385048,1702656784,1702656479,-305,0xad8663715b08f41a3aec47cc,444571,1580826,94265509190
160385049,1702656784,1702656479,-305,0xad8663715b08f41a3aec47cc,444572,1495958,94265509190
160385050,1702656784,1702656479,-305,0xad8663715b08f41a3aec47cc,444573,1604402,94265509190
160385051,1702656784,1702656479,-305,0xad8663715b08f41a3aec47cc,444574,1569874,94265509190
160385052,1702656784,1702656479,-305,0xad8663715b08f41a3aec47cc,444575,1591588,94265509190
160385053,1702656784,1702656479,-305,0xad8663715b08f41a3aec47cc,444576,1600758,94265509190
160385054,1702656784,1702656479,-305,0xad8663715b08f41a3aec47cc,444577,1553866,94265509190
160385055,1702656784,1702656527,-257,0xad8663715b08f41a3aec47cc,444578,1558830,93349478457
160385056,1702656784,1702656527,-257,0xad8663715b08f41a3aec47cc,444579,1592700,93349478457
160385057,1702656784,1702656527,-257,0xad8663715b08f41a3aec47cc,444580,1601442,93349478457
160385058,1702656784,1702656527,-257,0xad8663715b08f41a3aec47cc,444581,1577476,93349478457
160385059,1702656784,1702656527,-257,0xad8663715b08f41a3aec47cc,444582,1549678,93349478457
160385060,1702656784,1702656527,-257,0xad8663715b08f41a3aec47cc,444583,1562676,93349478457
160385061,1702656784,1702656527,-257,0xad8663715b08f41a3aec47cc,444584,1606642,93349478457
160385062,1702656784,1702656527,-257,0xad8663715b08f41a3aec47cc,444585,1563176,93349478457
160385063,1702656784,1702656527,-257,0xad8663715b08f41a3aec47cc,444586,1528192,93349478457
160385064,1702656784,1702656527,-257,0xad8663715b08f41a3aec47cc,444587,1612988,93349478457
160385065,1702656784,1702656527,-257,0xad8663715b08f41a3aec47cc,444588,1525942,93349478457
160385066,1702656784,1702656527,-257,0xad8663715b08f41a3aec47cc,444589,1503734,93349478457
160385067,1702656784,1702656539,-245,0xad8663715b08f41a3aec47cc,444590,1480526,100674044933
160385068,1702656784,1702656539,-245,0xad8663715b08f41a3aec47cc,444591,1543332,100674044933
160385069,1702656784,1702656539,-245,0xad8663715b08f41a3aec47cc,444592,1570458,100674044933
160385070,1702656784,1702656539,-245,0xad8663715b08f41a3aec47cc,444593,1563680,100674044933
160385071,1702656784,1702656551,-233,0xad8663715b08f41a3aec47cc,444594,1581846,105726343353
160385072,1702656784,1702656551,-233,0xad8663715b08f41a3aec47cc,444595,1524580,105726343353
160385073,1702656784,1702656551,-233,0xad8663715b08f41a3aec47cc,444596,1548444,105726343353
160385074,1702656784,1702656551,-233,0xad8663715b08f41a3aec47cc,444597,1608516,105726343353
160385075,1702656784,1702656551,-233,0xad8663715b08f41a3aec47cc,444598,1523226,105726343353
160385076,1702656784,1702656551,-233,0xad8663715b08f41a3aec47cc,444599,1582598,105726343353
160385077,1702656784,1702656551,-233,0xad8663715b08f41a3aec47cc,444600,1567080,105726343353
160385078,1702656784,1702656551,-233,0xad8663715b08f41a3aec47cc,444601,1460786,105726343353
160385079,1702656784,1702656551,-233,0xad8663715b08f41a3aec47cc,444602,1528432,105726343353
160385080,1702656784,1702656551,-233,0xad8663715b08f41a3aec47cc,444603,1476488,105726343353
160385081,1702656784,1702656551,-233,0xad8663715b08f41a3aec47cc,444604,1566438,105726343353
160385082,1702656784,1702656551,-233,0xad8663715b08f41a3aec47cc,444605,1534136,105726343353
160385083,1702656784,1702656563,-221,0xad8663715b08f41a3aec47cc,444606,1515444,118921442983
160385084,1702656784,1702656563,-221,0xad8663715b08f41a3aec47cc,444607,1599896,118921442983
160385085,1702656784,1702656563,-221,0xad8663715b08f41a3aec47cc,444608,1584042,118921442983
160385086,1702656784,1702656563,-221,0xad8663715b08f41a3aec47cc,444609,1599538,118921442983
160385087,1702656784,1702656575,-209,0xad8663715b08f41a3aec47cc,444610,1473426,117672049348
160385089,1702656784,1702656623,-161,0xad8663715b08f41a3aec47cc,444611,1551930,110172238132
160385090,1702656784,1702656623,-161,0xad8663715b08f41a3aec47cc,444612,1605948,110172238132
160385091,1702656784,1702656623,-161,0xad8663715b08f41a3aec47cc,444613,1593146,110172238132
160385092,1702656784,1702656623,-161,0xad8663715b08f41a3aec47cc,444614,1596806,110172238132
160385093,1702656784,1702656623,-161,0xad8663715b08f41a3aec47cc,444615,1495676,110172238132
160385094,1702656784,1702656623,-161,0xad8663715b08f41a3aec47cc,444616,1610442,110172238132
160385095,1702656784,1702656623,-161,0xad8663715b08f41a3aec47cc,444617,1573116,110172238132
160385096,1702656784,1702656623,-161,0xad8663715b08f41a3aec47cc,444618,1489622,110172238132
160385097,1702656784,1702656623,-161,0xad8663715b08f41a3aec47cc,444619,1576698,110172238132
160385098,1702656784,1702656623,-161,0xad8663715b08f41a3aec47cc,444620,1590310,110172238132
160385099,1702656784,1702656623,-161,0xad8663715b08f41a3aec47cc,444621,1518392,110172238132
160385100,1702656784,1702656623,-161,0xad8663715b08f41a3aec47cc,444622,1538408,110172238132
160385101,1702656784,1702656623,-161,0xad8663715b08f41a3aec47cc,444623,1519678,110172238132
160385102,1702656784,1702656635,-149,0xad8663715b08f41a3aec47cc,444624,1580348,123920521556
160385103,1702656784,1702656635,-149,0xad8663715b08f41a3aec47cc,444625,1589646,123920521556
160385104,1702656784,1702656647,-137,0xad8663715b08f41a3aec47cc,444626,1576534,114540417572
160385105,1702656784,1702656647,-137,0xad8663715b08f41a3aec47cc,444627,1532816,114540417572
160385107,1702657488,1702656647,-841,0xad8663715b08f41a3aec47cc,444628,1608216,114540417572
160385108,1702657488,1702656647,-841,0xad8663715b08f41a3aec47cc,444629,1563828,114540417572
160385109,1702657488,1702656647,-841,0xad8663715b08f41a3aec47cc,444630,1495796,114540417572
160385110,1702657488,1702656647,-841,0xad8663715b08f41a3aec47cc,444631,1505588,114540417572
160385111,1702657488,1702656647,-841,0xad8663715b08f41a3aec47cc,444632,1532724,114540417572
160385112,1702657488,1702656647,-841,0xad8663715b08f41a3aec47cc,444633,1563292,114540417572
160385113,1702657488,1702656647,-841,0xad8663715b08f41a3aec47cc,444634,1546514,114540417572
160385114,1702657488,1702656647,-841,0xad8663715b08f41a3aec47cc,444635,1600020,114540417572
160385115,1702657488,1702656647,-841,0xad8663715b08f41a3aec47cc,444636,1562786,114540417572
160385116,1702657488,1702656647,-841,0xad8663715b08f41a3aec47cc,444637,1509362,114540417572
160385117,1702657488,1702656647,-841,0xad8663715b08f41a3aec47cc,444638,1614034,114540417572
160385118,1702657488,1702656659,-829,0xad8663715b08f41a3aec47cc,444639,1551890,128841430132
160385119,1702657488,1702656659,-829,0xad8663715b08f41a3aec47cc,444640,1573328,128841430132
160385120,1702657488,1702656659,-829,0xad8663715b08f41a3aec47cc,444641,1526876,128841430132
160385121,1702657488,1702656659,-829,0xad8663715b08f41a3aec47cc,444642,1578282,128841430132
160385122,1702657488,1702656659,-829,0xad8663715b08f41a3aec47cc,444643,1534952,128841430132
160385123,1702657488,1702656659,-829,0xad8663715b08f41a3aec47cc,444644,1544268,128841430132
160385124,1702657488,1702656659,-829,0xad8663715b08f41a3aec47cc,444645,1588504,128841430132
160385125,1702657488,1702656659,-829,0xad8663715b08f41a3aec47cc,444646,1534704,128841430132
160385126,1702657488,1702656659,-829,0xad8663715b08f41a3aec47cc,444647,1588730,128841430132
160385127,1702657488,1702656659,-829,0xad8663715b08f41a3aec47cc,444648,1586440,128841430132
160385128,1702657488,1702656659,-829,0xad8663715b08f41a3aec47cc,444649,1562460,128841430132
160385129,1702657488,1702656659,-829,0xad8663715b08f41a3aec47cc,444650,1531042,128841430132
160385130,1702657488,1702656659,-829,0xad8663715b08f41a3aec47cc,444651,1587754,128841430132
160385131,1702657488,1702656659,-829,0xad8663715b08f41a3aec47cc,444652,1558006,128841430132
160385132,1702657488,1702656659,-829,0xad8663715b08f41a3aec47cc,444653,1606510,128841430132
160385134,1702657488,1702656695,-793,0xad8663715b08f41a3aec47cc,444654,1578316,139176705302
160385135,1702657488,1702656695,-793,0xad8663715b08f41a3aec47cc,444655,1569418,139176705302
160385136,1702657488,1702656695,-793,0xad8663715b08f41a3aec47cc,444656,1596332,139176705302
160385137,1702657488,1702656695,-793,0xad8663715b08f41a3aec47cc,444657,1531314,139176705302
160385138,1702657488,1702656695,-793,0xad8663715b08f41a3aec47cc,444658,1610986,139176705302
160385139,1702657488,1702656695,-793,0xad8663715b08f41a3aec47cc,444659,1568514,139176705302
160385140,1702657488,1702656695,-793,0xad8663715b08f41a3aec47cc,444660,1594502,139176705302
160385141,1702657488,1702656695,-793,0xad8663715b08f41a3aec47cc,444661,1568530,139176705302
160385142,1702657488,1702656695,-793,0xad8663715b08f41a3aec47cc,444662,1601172,139176705302
160385143,1702657488,1702656695,-793,0xad8663715b08f41a3aec47cc,444663,1532822,139176705302
160385144,1702657488,1702656695,-793,0xad8663715b08f41a3aec47cc,444664,1550548,139176705302
160385145,1702657488,1702656695,-793,0xad8663715b08f41a3aec47cc,444665,1544480,139176705302
160385146,1702657488,1702656695,-793,0xad8663715b08f41a3aec47cc,444666,1542802,139176705302
160385149,1702657488,1702656767,-721,0xad8663715b08f41a3aec47cc,444667,1532980,117847155013
160385152,1702657488,1702656839,-649,0xad8663715b08f41a3aec47cc,444668,1520778,94591023741
160385155,1702657488,1702656959,-529,0xad8663715b08f41a3aec47cc,444669,1565588,75499129106
160385157,1702657488,1702657007,-481,0xad8663715b08f41a3aec47cc,444670,1584644,72329508218
160385158,1702657488,1702657007,-481,0xad8663715b08f41a3aec47cc,444671,1611020,72329508218
160385159,1702657488,1702657007,-481,0xad8663715b08f41a3aec47cc,444672,1595286,72329508218
160385160,1702657488,1702657007,-481,0xad8663715b08f41a3aec47cc,444673,1609096,72329508218
160385161,1702657488,1702657007,-481,0xad8663715b08f41a3aec47cc,444674,1568788,72329508218
160385162,1702657488,1702657007,-481,0xad8663715b08f41a3aec47cc,444675,1563472,72329508218
160385163,1702657488,1702657007,-481,0xad8663715b08f41a3aec47cc,444676,1524114,72329508218
160385164,1702657488,1702657007,-481,0xad8663715b08f41a3aec47cc,444677,1569874,72329508218
160385165,1702657488,1702657007,-481,0xad8663715b08f41a3aec47cc,444678,1599410,72329508218
160385166,1702657488,1702657007,-481,0xad8663715b08f41a3aec47cc,444679,1537700,72329508218
160385167,1702657488,1702657007,-481,0xad8663715b08f41a3aec47cc,444680,1575344,72329508218
160385168,1702657488,1702657007,-481,0xad8663715b08f41a3aec47cc,444681,1549980,72329508218
160385169,1702657488,1702657007,-481,0xad8663715b08f41a3aec47cc,444682,1542362,72329508218
160385170,1702657488,1702657019,-469,0xad8663715b08f41a3aec47cc,444683,1567458,81332127637
160385171,1702657488,1702657019,-469,0xad8663715b08f41a3aec47cc,444684,1593660,81332127637
160385172,1702657488,1702657019,-469,0xad8663715b08f41a3aec47cc,444685,1509882,81332127637
160385173,1702657488,1702657019,-469,0xad8663715b08f41a3aec47cc,444686,1567646,81332127637
160385175,1702657488,1702657055,-433,0xad8663715b08f41a3aec47cc,444687,1582878,79008177578
160385176,1702657488,1702657055,-433,0xad8663715b08f41a3aec47cc,444688,1580032,79008177578
160385177,1702657488,1702657055,-433,0xad8663715b08f41a3aec47cc,444689,1600658,79008177578
160385178,1702657488,1702657055,-433,0xad8663715b08f41a3aec47cc,444690,1619060,79008177578
160385179,1702657488,1702657055,-433,0xad8663715b08f41a3aec47cc,444691,1572184,79008177578
160385180,1702657488,1702657055,-433,0xad8663715b08f41a3aec47cc,444692,1599666,79008177578
160385181,1702657488,1702657055,-433,0xad8663715b08f41a3aec47cc,444693,1540048,79008177578
160385182,1702657488,1702657055,-433,0xad8663715b08f41a3aec47cc,444694,1531360,79008177578
160385183,1702657488,1702657055,-433,0xad8663715b08f41a3aec47cc,444695,1554410,79008177578
160385184,1702657488,1702657055,-433,0xad8663715b08f41a3aec47cc,444696,1606660,79008177578
160385185,1702657488,1702657055,-433,0xad8663715b08f41a3aec47cc,444697,1554436,79008177578
160385186,1702657488,1702657055,-433,0xad8663715b08f41a3aec47cc,444698,1550236,79008177578
160385187,1702657488,1702657055,-433,0xad8663715b08f41a3aec47cc,444699,1615030,79008177578
160385188,1702657488,1702657055,-433,0xad8663715b08f41a3aec47cc,444700,1547684,79008177578
160385189,1702657488,1702657067,-421,0xad8663715b08f41a3aec47cc,444701,1575828,88879016180
160385190,1702657488,1702657067,-421,0xad8663715b08f41a3aec47cc,444702,1576524,88879016180
160385191,1702657488,1702657067,-421,0xad8663715b08f41a3aec47cc,444703,1540728,88879016180
160385193,1702657488,1702657079,-409,0xad8663715b08f41a3aec47cc,444704,1615200,93792510387
160385194,1702657488,1702657079,-409,0xad8663715b08f41a3aec47cc,444705,1609190,93792510387
160385195,1702657488,1702657079,-409,0xad8663715b08f41a3aec47cc,444706,1510882,93792510387
160385196,1702657488,1702657079,-409,0xad8663715b08f41a3aec47cc,444707,1517142,93792510387
160385197,1702657488,1702657079,-409,0xad8663715b08f41a3aec47cc,444708,1541274,93792510387
160385198,1702657488,1702657079,-409,0xad8663715b08f41a3aec47cc,444709,1541262,93792510387
160385199,1702657488,1702657079,-409,0xad8663715b08f41a3aec47cc,444710,1568386,93792510387
160385200,1702657488,1702657079,-409,0xad8663715b08f41a3aec47cc,444711,1582484,93792510387
160385201,1702657488,1702657079,-409,0xad8663715b08f41a3aec47cc,444712,1583172,93792510387
160385202,1702657488,1702657079,-409,0xad8663715b08f41a3aec47cc,444713,1558378,93792510387
160385203,1702657488,1702657079,-409,0xad8663715b08f41a3aec47cc,444714,1525264,93792510387
160385204,1702657488,1702657079,-409,0xad8663715b08f41a3aec47cc,444715,1571688,93792510387
160385205,1702657488,1702657079,-409,0xad8663715b08f41a3aec47cc,444716,1552358,93792510387
160385206,1702657488,1702657079,-409,0xad8663715b08f41a3aec47cc,444717,1596350,93792510387
160385207,1702657488,1702657091,-397,0xad8663715b08f41a3aec47cc,444718,1616280,105507842884
160385208,1702657488,1702657091,-397,0xad8663715b08f41a3aec47cc,444719,1589762,105507842884
160385209,1702657488,1702657103,-385,0xad8663715b08f41a3aec47cc,444720,1549982,106351865182
160385210,1702657488,1702657103,-385,0xad8663715b08f41a3aec47cc,444721,1591748,106351865182
160385211,1702657488,1702657103,-385,0xad8663715b08f41a3aec47cc,444722,1569128,106351865182
160385212,1702657488,1702657103,-385,0xad8663715b08f41a3aec47cc,444723,1609926,106351865182
160385213,1702657488,1702657103,-385,0xad8663715b08f41a3aec47cc,444724,1552880,106351865182
160385214,1702657488,1702657103,-385,0xad8663715b08f41a3aec47cc,444725,1570164,106351865182
160385215,1702657488,1702657103,-385,0xad8663715b08f41a3aec47cc,444726,1603972,106351865182
160385216,1702657488,1702657103,-385,0xad8663715b08f41a3aec47cc,444727,1557638,106351865182
160385217,1702657488,1702657103,-385,0xad8663715b08f41a3aec47cc,444728,1494450,106351865182
160385218,1702657488,1702657103,-385,0xad8663715b08f41a3aec47cc,444729,1565772,106351865182
160385219,1702657488,1702657103,-385,0xad8663715b08f41a3aec47cc,444730,1578678,106351865182
160385220,1702657488,1702657103,-385,0xad8663715b08f41a3aec47cc,444731,1587166,106351865182
160385221,1702657488,1702657103,-385,0xad8663715b08f41a3aec47cc,444732,1601796,106351865182
160385222,1702657488,1702657103,-385,0xad8663715b08f41a3aec47cc,444733,1540648,106351865182
160385224,1702657488,1702657115,-373,0xad8663715b08f41a3aec47cc,444734,1493372,119623247672
160385225,1702657488,1702657115,-373,0xad8663715b08f41a3aec47cc,444735,1606888,119623247672
160385226,1702657488,1702657115,-373,0xad8663715b08f41a3aec47cc,444736,1580516,119623247672
160385227,1702657488,1702657115,-373,0xad8663715b08f41a3aec47cc,444737,1575312,119623247672
160385228,1702657488,1702657115,-373,0xad8663715b08f41a3aec47cc,444738,1543338,119623247672
160385229,1702657488,1702657127,-361,0xad8663715b08f41a3aec47cc,444739,1582572,127530677294
160385230,1702657488,1702657127,-361,0xad8663715b08f41a3aec47cc,444740,1604506,127530677294
160385231,1702657488,1702657127,-361,0xad8663715b08f41a3aec47cc,444741,1586254,127530677294
160385232,1702657488,1702657127,-361,0xad8663715b08f41a3aec47cc,444742,1607360,127530677294
160385233,1702657488,1702657127,-361,0xad8663715b08f41a3aec47cc,444743,1551228,127530677294
160385234,1702657488,1702657127,-361,0xad8663715b08f41a3aec47cc,444744,1540860,127530677294
160385235,1702657488,1702657127,-361,0xad8663715b08f41a3aec47cc,444745,1593170,127530677294
160385236,1702657488,1702657127,-361,0xad8663715b08f41a3aec47cc,444746,1574854,127530677294
160385237,1702657488,1702657127,-361,0xad8663715b08f41a3aec47cc,444747,1598396,127530677294
160385238,1702657488,1702657127,-361,0xad8663715b08f41a3aec47cc,444748,1564342,127530677294
160385239,1702657488,1702657139,-349,0xad8663715b08f41a3aec47cc,444749,1567996,135176013867
160385240,1702657488,1702657139,-349,0xad8663715b08f41a3aec47cc,444750,1537904,135176013867
160385241,1702657488,1702657139,-349,0xad8663715b08f41a3aec47cc,444751,1552722,135176013867
160385242,1702657488,1702657139,-349,0xad8663715b08f41a3aec47cc,444752,1587462,135176013867
160385243,1702657488,1702657139,-349,0xad8663715b08f41a3aec47cc,444753,1560704,135176013867
160385244,1702657488,1702657151,-337,0xad8663715b08f41a3aec47cc,444754,1541652,139022339200
160385245,1702657488,1702657151,-337,0xad8663715b08f41a3aec47cc,444755,1551360,139022339200
160385246,1702657488,1702657151,-337,0xad8663715b08f41a3aec47cc,444756,1601422,139022339200
160385247,1702657488,1702657151,-337,0xad8663715b08f41a3aec47cc,444757,1571096,139022339200
160385248,1702657488,1702657151,-337,0xad8663715b08f41a3aec47cc,444758,1564876,139022339200
160385249,1702657488,1702657151,-337,0xad8663715b08f41a3aec47cc,444759,1535390,139022339200
160385250,1702657488,1702657151,-337,0xad8663715b08f41a3aec47cc,444760,1550356,139022339200
160385251,1702657488,1702657151,-337,0xad8663715b08f41a3aec47cc,444761,1566028,139022339200
160385252,1702657488,1702657151,-337,0xad8663715b08f41a3aec47cc,444762,1547026,139022339200
160385253,1702657488,1702657151,-337,0xad8663715b08f41a3aec47cc,444763,1592342,139022339200
160385254,1702657488,1702657175,-313,0xad8663715b08f41a3aec47cc,444764,1612984,139838780067
160385255,1702657488,1702657175,-313,0xad8663715b08f41a3aec47cc,444765,1609538,139838780067
160385256,1702657488,1702657175,-313,0xad8663715b08f41a3aec47cc,444766,1547196,139838780067
160385257,1702657488,1702657175,-313,0xad8663715b08f41a3aec47cc,444767,1516514,139838780067
160385258,1702657488,1702657175,-313,0xad8663715b08f41a3aec47cc,444768,1582668,139838780067
160385259,1702657488,1702657175,-313,0xad8663715b08f41a3aec47cc,444769,1510972,139838780067
160385260,1702657488,1702657175,-313,0xad8663715b08f41a3aec47cc,444770,1524340,139838780067
160385261,1702657488,1702657175,-313,0xad8663715b08f41a3aec47cc,444771,1535410,139838780067
160385262,1702657488,1702657175,-313,0xad8663715b08f41a3aec47cc,444772,1601932,139838780067
160385263,1702657488,1702657175,-313,0xad8663715b08f41a3aec47cc,444773,1546882,139838780067
160385264,1702657488,1702657175,-313,0xad8663715b08f41a3aec47cc,444774,1576782,139838780067
160385265,1702657488,1702657175,-313,0xad8663715b08f41a3aec47cc,444775,1603422,139838780067
160385266,1702657488,1702657175,-313,0xad8663715b08f41a3aec47cc,444776,1547798,139838780067
160385267,1702657488,1702657175,-313,0xad8663715b08f41a3aec47cc,444777,1555810,139838780067
160385268,1702657488,1702657211,-277,0xad8663715b08f41a3aec47cc,444778,1563854,139774786643
160385269,1702657488,1702657211,-277,0xad8663715b08f41a3aec47cc,444779,1540446,139774786643
160385270,1702657488,1702657211,-277,0xad8663715b08f41a3aec47cc,444780,1554236,139774786643
160385271,1702657488,1702657211,-277,0xad8663715b08f41a3aec47cc,444781,1575892,139774786643
160385272,1702657488,1702657211,-277,0xad8663715b08f41a3aec47cc,444782,1539404,139774786643
160385273,1702657488,1702657211,-277,0xad8663715b08f41a3aec47cc,444783,1610836,139774786643
160385274,1702657488,1702657211,-277,0xad8663715b08f41a3aec47cc,444784,1595654,139774786643
160385275,1702657488,1702657211,-277,0xad8663715b08f41a3aec47cc,444785,1593854,139774786643
160385276,1702657488,1702657211,-277,0xad8663715b08f41a3aec47cc,444786,1575844,139774786643
160385277,1702657488,1702657211,-277,0xad8663715b08f41a3aec47cc,444787,1593378,139774786643
160385278,1702657488,1702657211,-277,0xad8663715b08f41a3aec47cc,444788,1574778,139774786643
160385279,1702657488,1702657211,-277,0xad8663715b08f41a3aec47cc,444789,1611350,139774786643
160385280,1702657488,1702657211,-277,0xad8663715b08f41a3aec47cc,444790,1566408,139774786643
160385281,1702657488,1702657211,-277,0xad8663715b08f41a3aec47cc,444791,1571798,139774786643
160385282,1702657488,1702657247,-241,0xad8663715b08f41a3aec47cc,444792,1580242,137896605498
160385283,1702657488,1702657247,-241,0xad8663715b08f41a3aec47cc,444793,1448322,137896605498
160385284,1702657488,1702657247,-241,0xad8663715b08f41a3aec47cc,444794,1602244,137896605498
160385285,1702657488,1702657247,-241,0xad8663715b08f41a3aec47cc,444795,1584028,137896605498
160385286,1702657488,1702657247,-241,0xad8663715b08f41a3aec47cc,444796,1605980,137896605498
160385287,1702657488,1702657247,-241,0xad8663715b08f41a3aec47cc,444797,1586682,137896605498
160385288,1702657488,1702657247,-241,0xad8663715b08f41a3aec47cc,444798,1588866,137896605498
160385289,1702657488,1702657247,-241,0xad8663715b08f41a3aec47cc,444799,1503652,137896605498
160385290,1702657488,1702657247,-241,0xad8663715b08f41a3aec47cc,444800,1588950,137896605498
160385291,1702657488,1702657247,-241,0xad8663715b08f41a3aec47cc,444801,1592684,137896605498
160385292,1702657488,1702657247,-241,0xad8663715b08f41a3aec47cc,444802,1595760,137896605498
160385293,1702657488,1702657247,-241,0xad8663715b08f41a3aec47cc,444803,1528058,137896605498
160385294,1702657488,1702657247,-241,0xad8663715b08f41a3aec47cc,444804,1536214,137896605498
160385295,1702657488,1702657247,-241,0xad8663715b08f41a3aec47cc,444805,1539160,137896605498
160385296,1702657488,1702657271,-217,0xad8663715b08f41a3aec47cc,444806,1530242,143635496683
160385297,1702657488,1702657271,-217,0xad8663715b08f41a3aec47cc,444807,1579874,143635496683
160385298,1702657488,1702657271,-217,0xad8663715b08f41a3aec47cc,444808,1515782,143635496683
160385299,1702657488,1702657295,-193,0xad8663715b08f41a3aec47cc,444809,1601960,136100330108
160385300,1702657488,1702657295,-193,0xad8663715b08f41a3aec47cc,444810,1611476,136100330108
160385301,1702657488,1702657295,-193,0xad8663715b08f41a3aec47cc,444811,1539548,136100330108
160385302,1702657488,1702657295,-193,0xad8663715b08f41a3aec47cc,444812,1522894,136100330108
160385303,1702657488,1702657295,-193,0xad8663715b08f41a3aec47cc,444813,1589966,136100330108
160385304,1702657488,1702657295,-193,0xad8663715b08f41a3aec47cc,444814,1562464,136100330108
160385305,1702657488,1702657295,-193,0xad8663715b08f41a3aec47cc,444815,1521304,136100330108
160385306,1702657488,1702657295,-193,0xad8663715b08f41a3aec47cc,444816,1561262,136100330108
160385307,1702657488,1702657295,-193,0xad8663715b08f41a3aec47cc,444817,1586690,136100330108
160385308,1702657488,1702657295,-193,0xad8663715b08f41a3aec47cc,444818,1564020,136100330108
160385309,1702657488,1702657295,-193,0xad8663715b08f41a3aec47cc,444819,1612962,136100330108
160385310,1702657488,1702657295,-193,0xad8663715b08f41a3aec47cc,444820,1595824,136100330108
160385311,1702657488,1702657295,-193,0xad8663715b08f41a3aec47cc,444821,1545308,136100330108
160385312,1702657488,1702657295,-193,0xad8663715b08f41a3aec47cc,444822,1585312,136100330108
160385313,1702657488,1702657319,-169,0xad8663715b08f41a3aec47cc,444823,1575610,148814931233
160385314,1702657488,1702657331,-157,0xad8663715b08f41a3aec47cc,444824,1551944,136956107467
160385315,1702657488,1702657331,-157,0xad8663715b08f41a3aec47cc,444825,1560690,136956107467
160385316,1702657488,1702657331,-157,0xad8663715b08f41a3aec47cc,444826,1587730,136956107467
160385317,1702657488,1702657331,-157,0xad8663715b08f41a3aec47cc,444827,1549112,136956107467
160385318,1702657488,1702657331,-157,0xad8663715b08f41a3aec47cc,444828,1590340,136956107467
160385319,1702657488,1702657331,-157,0xad8663715b08f41a3aec47cc,444829,1584864,136956107467
160385320,1702657488,1702657331,-157,0xad8663715b08f41a3aec47cc,444830,1572184,136956107467
160385321,1702657488,1702657331,-157,0xad8663715b08f41a3aec47cc,444831,1573144,136956107467
160385322,1702657488,1702657331,-157,0xad8663715b08f41a3aec47cc,444832,1578526,136956107467
160385323,1702657488,1702657331,-157,0xad8663715b08f41a3aec47cc,444833,1600720,136956107467
160385324,1702657488,1702657331,-157,0xad8663715b08f41a3aec47cc,444834,1599538,136956107467
160385325,1702657488,1702657331,-157,0xad8663715b08f41a3aec47cc,444835,1579878,136956107467
160385326,1702657488,1702657367,-121,0xad8663715b08f41a3aec47cc,444836,1564286,136998245373
160385327,1702657488,1702657367,-121,0xad8663715b08f41a3aec47cc,444837,1548988,136998245373
160385328,1702657488,1702657367,-121,0xad8663715b08f41a3aec47cc,444838,1535726,136998245373
160385329,1702657488,1702657367,-121,0xad8663715b08f41a3aec47cc,444839,1596960,136998245373
160385330,1702657488,1702657367,-121,0xad8663715b08f41a3aec47cc,444840,1593582,136998245373
160385331,1702657488,1702657367,-121,0xad8663715b08f41a3aec47cc,444841,1595194,136998245373
160385332,1702657488,1702657367,-121,0xad8663715b08f41a3aec47cc,444842,1531226,136998245373
160385333,1702657488,1702657367,-121,0xad8663715b08f41a3aec47cc,444843,1544490,136998245373
160385334,1702657488,1702657367,-121,0xad8663715b08f41a3aec47cc,444844,1605400,136998245373
160385335,1702657488,1702657367,-121,0xad8663715b08f41a3aec47cc,444845,1604246,136998245373
160385336,1702657488,1702657367,-121,0xad8663715b08f41a3aec47cc,444846,1565000,136998245373
160385337,1702657488,1702657367,-121,0xad8663715b08f41a3aec47cc,444847,1580012,136998245373
160385338,1702657488,1702657367,-121,0xad8663715b08f41a3aec47cc,444848,1588446,136998245373
160385339,1702657488,1702657367,-121,0xad8663715b08f41a3aec47cc,444849,1600946,136998245373
160385341,1702657995,1702657403,-592,0xad8663715b08f41a3aec47cc,444850,1560546,140958709324
160385342,1702657995,1702657403,-592,0xad8663715b08f41a3aec47cc,444851,1571618,140958709324
160385343,1702657995,1702657403,-592,0xad8663715b08f41a3aec47cc,444852,1577654,140958709324
160385344,1702657995,1702657403,-592,0xad8663715b08f41a3aec47cc,444853,1590070,140958709324
160385345,1702657995,1702657403,-592,0xad8663715b08f41a3aec47cc,444854,1497030,140958709324
160385346,1702657995,1702657403,-592,0xad8663715b08f41a3aec47cc,444855,1596322,140958709324
160385347,1702657995,1702657403,-592,0xad8663715b08f41a3aec47cc,444856,1602374,140958709324
160385348,1702657995,1702657403,-592,0xad8663715b08f41a3aec47cc,444857,1549546,140958709324
160385349,1702657995,1702657403,-592,0xad8663715b08f41a3aec47cc,444858,1610040,140958709324
160385350,1702657995,1702657403,-592,0xad8663715b08f41a3aec47cc,444859,1577384,140958709324
160385351,1702657995,1702657403,-592,0xad8663715b08f41a3aec47cc,444860,1547386,140958709324
160385352,1702657995,1702657403,-592,0xad8663715b08f41a3aec47cc,444861,1464142,140958709324
160385353,1702657995,1702657403,-592,0xad8663715b08f41a3aec47cc,444862,1594384,140958709324
160385354,1702657995,1702657403,-592,0xad8663715b08f41a3aec47cc,444863,1567810,140958709324
160385355,1702657995,1702657427,-568,0xad8663715b08f41a3aec47cc,444864,1571162,152733331519
160385356,1702657995,1702657439,-556,0xad8663715b08f41a3aec47cc,444865,1559208,144413296562
160385357,1702657995,1702657439,-556,0xad8663715b08f41a3aec47cc,444866,1547460,144413296562
160385358,1702657995,1702657463,-532,0xad8663715b08f41a3aec47cc,444867,1605254,137016692670
160385359,1702657995,1702657463,-532,0xad8663715b08f41a3aec47cc,444868,1560872,137016692670
160385360,1702657995,1702657463,-532,0xad8663715b08f41a3aec47cc,444869,1529864,137016692670
160385361,1702657995,1702657463,-532,0xad8663715b08f41a3aec47cc,444870,1569406,137016692670
160385362,1702657995,1702657463,-532,0xad8663715b08f41a3aec47cc,444871,1546214,137016692670
160385363,1702657995,1702657463,-532,0xad8663715b08f41a3aec47cc,444872,1561424,137016692670
160385364,1702657995,1702657463,-532,0xad8663715b08f41a3aec47cc,444873,1592708,137016692670
160385365,1702657995,1702657463,-532,0xad8663715b08f41a3aec47cc,444874,1539640,137016692670
160385366,1702657995,1702657463,-532,0xad8663715b08f41a3aec47cc,444875,1576084,137016692670
160385367,1702657995,1702657463,-532,0xad8663715b08f41a3aec47cc,444876,1550046,137016692670
160385368,1702657995,1702657463,-532,0xad8663715b08f41a3aec47cc,444877,1565440,137016692670
160385369,1702657995,1702657463,-532,0xad8663715b08f41a3aec47cc,444878,1608012,137016692670
160385370,1702657995,1702657463,-532,0xad8663715b08f41a3aec47cc,444879,1548756,137016692670
160385371,1702657995,1702657463,-532,0xad8663715b08f41a3aec47cc,444880,1524974,137016692670
160385372,1702657995,1702657463,-532,0xad8663715b08f41a3aec47cc,444881,1609794,137016692670
160385373,1702657995,1702657487,-508,0xad8663715b08f41a3aec47cc,444882,1613818,153531806891
160385374,1702657995,1702657511,-484,0xad8663715b08f41a3aec47cc,444883,1516296,141578466918
160385375,1702657995,1702657511,-484,0xad8663715b08f41a3aec47cc,444884,1593816,141578466918
160385376,1702657995,1702657511,-484,0xad8663715b08f41a3aec47cc,444885,1602592,141578466918
160385377,1702657995,1702657511,-484,0xad8663715b08f41a3aec47cc,444886,1558328,141578466918
160385378,1702657995,1702657511,-484,0xad8663715b08f41a3aec47cc,444887,1582722,141578466918
160385379,1702657995,1702657535,-460,0xad8663715b08f41a3aec47cc,444888,1613762,133575681293
160385380,1702657995,1702657535,-460,0xad8663715b08f41a3aec47cc,444889,1465628,133575681293
160385381,1702657995,1702657535,-460,0xad8663715b08f41a3aec47cc,444890,1558128,133575681293
160385382,1702657995,1702657535,-460,0xad8663715b08f41a3aec47cc,444891,1595226,133575681293
160385383,1702657995,1702657535,-460,0xad8663715b08f41a3aec47cc,444892,1609634,133575681293
160385384,1702657995,1702657535,-460,0xad8663715b08f41a3aec47cc,444893,1565322,133575681293
160385385,1702657995,1702657535,-460,0xad8663715b08f41a3aec47cc,444894,1582520,133575681293
160385386,1702657995,1702657535,-460,0xad8663715b08f41a3aec47cc,444895,1561788,133575681293
160385387,1702657995,1702657535,-460,0xad8663715b08f41a3aec47cc,444896,1592074,133575681293
160385388,1702657995,1702657535,-460,0xad8663715b08f41a3aec47cc,444897,1519554,133575681293
160385389,1702657995,1702657535,-460,0xad8663715b08f41a3aec47cc,444898,1570972,133575681293
160385390,1702657995,1702657535,-460,0xad8663715b08f41a3aec47cc,444899,1595594,133575681293
160385391,1702657995,1702657535,-460,0xad8663715b08f41a3aec47cc,444900,1532404,133575681293
160385392,1702657995,1702657559,-436,0xad8663715b08f41a3aec47cc,444901,1543594,145967060465
160385393,1702657995,1702657571,-424,0xad8663715b08f41a3aec47cc,444902,1560024,138248695741
160385394,1702657995,1702657571,-424,0xad8663715b08f41a3aec47cc,444903,1611466,138248695741
160385395,1702657995,1702657571,-424,0xad8663715b08f41a3aec47cc,444904,1583100,138248695741
160385396,1702657995,1702657571,-424,0xad8663715b08f41a3aec47cc,444905,1520298,138248695741
160385397,1702657995,1702657571,-424,0xad8663715b08f41a3aec47cc,444906,1592678,138248695741
160385398,1702657995,1702657571,-424,0xad8663715b08f41a3aec47cc,444907,1512766,138248695741
160385399,1702657995,1702657571,-424,0xad8663715b08f41a3aec47cc,444908,1507088,138248695741
160385400,1702657995,1702657571,-424,0xad8663715b08f41a3aec47cc,444909,1540602,138248695741
160385401,1702657995,1702657571,-424,0xad8663715b08f41a3aec47cc,444910,1535674,138248695741
160385402,1702657995,1702657571,-424,0xad8663715b08f41a3aec47cc,444911,1573952,138248695741
160385403,1702657995,1702657571,-424,0xad8663715b08f41a3aec47cc,444912,1596672,138248695741
160385404,1702657995,1702657571,-424,0xad8663715b08f41a3aec47cc,444913,1541948,138248695741
160385405,1702657995,1702657571,-424,0xad8663715b08f41a3aec47cc,444914,1589180,138248695741
160385406,1702657995,1702657571,-424,0xad8663715b08f41a3aec47cc,444915,1605742,138248695741
160385407,1702657995,1702657607,-388,0xad8663715b08f41a3aec47cc,444916,1534264,139008033837
160385408,1702657995,1702657607,-388,0xad8663715b08f41a3aec47cc,444917,1578262,139008033837
160385409,1702657995,1702657607,-388,0xad8663715b08f41a3aec47cc,444918,1534186,139008033837
160385410,1702657995,1702657607,-388,0xad8663715b08f41a3aec47cc,444919,1609038,139008033837
160385411,1702657995,1702657607,-388,0xad8663715b08f41a3aec47cc,444920,1552250,139008033837
160385412,1702657995,1702657607,-388,0xad8663715b08f41a3aec47cc,444921,1613358,139008033837
160385413,1702657995,1702657607,-388,0xad8663715b08f41a3aec47cc,444922,1556516,139008033837
160385414,1702657995,1702657607,-388,0xad8663715b08f41a3aec47cc,444923,1576870,139008033837
160385415,1702657995,1702657607,-388,0xad8663715b08f41a3aec47cc,444924,1588680,139008033837
160385416,1702657995,1702657607,-388,0xad8663715b08f41a3aec47cc,444925,1610258,139008033837
160385417,1702657995,1702657607,-388,0xad8663715b08f41a3aec47cc,444926,1539388,139008033837
160385418,1702657995,1702657607,-388,0xad8663715b08f41a3aec47cc,444927,1547584,139008033837
160385419,1702657995,1702657607,-388,0xad8663715b08f41a3aec47cc,444928,1555428,139008033837
160385420,1702657995,1702657607,-388,0xad8663715b08f41a3aec47cc,444929,1564356,139008033837
160385421,1702657995,1702657607,-388,0xad8663715b08f41a3aec47cc,444930,1589580,139008033837
160385422,1702657995,1702657631,-364,0xad8663715b08f41a3aec47cc,444931,1611298,146849079144
160385423,1702657995,1702657643,-352,0xad8663715b08f41a3aec47cc,444932,1580870,138443164960
160385424,1702657995,1702657643,-352,0xad8663715b08f41a3aec47cc,444933,1566608,138443164960
160385425,1702657995,1702657643,-352,0xad8663715b08f41a3aec47cc,444934,1583810,138443164960
160385426,1702657995,1702657643,-352,0xad8663715b08f41a3aec47cc,444935,1575016,138443164960
160385427,1702657995,1702657643,-352,0xad8663715b08f41a3aec47cc,444936,1596988,138443164960
160385428,1702657995,1702657643,-352,0xad8663715b08f41a3aec47cc,444937,1569362,138443164960
160385429,1702657995,1702657643,-352,0xad8663715b08f41a3aec47cc,444938,1533124,138443164960
160385430,1702657995,1702657643,-352,0xad8663715b08f41a3aec47cc,444939,1549068,138443164960
160385431,1702657995,1702657643,-352,0xad8663715b08f41a3aec47cc,444940,1554996,138443164960
160385432,1702657995,1702657643,-352,0xad8663715b08f41a3aec47cc,444941,1605378,138443164960
160385433,1702657995,1702657643,-352,0xad8663715b08f41a3aec47cc,444942,1535952,138443164960
160385434,1702657995,1702657643,-352,0xad8663715b08f41a3aec47cc,444943,1543058,138443164960
160385435,1702657995,1702657643,-352,0xad8663715b08f41a3aec47cc,444944,1560646,138443164960
160385436,1702657995,1702657643,-352,0xad8663715b08f41a3aec47cc,444945,1563148,138443164960
160385437,1702657995,1702657667,-328,0xad8663715b08f41a3aec47cc,444946,1606508,142648129920
160385438,1702657995,1702657667,-328,0xad8663715b08f41a3aec47cc,444947,1585050,142648129920
160385439,1702657995,1702657667,-328,0xad8663715b08f41a3aec47cc,444948,1579220,142648129920
160385440,1702657995,1702657691,-304,0xad8663715b08f41a3aec47cc,444949,1599754,130064604848
160385441,1702657995,1702657691,-304,0xad8663715b08f41a3aec47cc,444950,1577634,130064604848
160385442,1702657995,1702657691,-304,0xad8663715b08f41a3aec47cc,444951,1587428,130064604848
160385443,1702657995,1702657691,-304,0xad8663715b08f41a3aec47cc,444952,1591422,130064604848
160385444,1702657995,1702657691,-304,0xad8663715b08f41a3aec47cc,444953,1571178,130064604848
160385445,1702657995,1702657691,-304,0xad8663715b08f41a3aec47cc,444954,1529326,130064604848
160385446,1702657995,1702657691,-304,0xad8663715b08f41a3aec47cc,444955,1614838,130064604848
160385447,1702657995,1702657691,-304,0xad8663715b08f41a3aec47cc,444956,1564088,130064604848
160385448,1702657995,1702657691,-304,0xad8663715b08f41a3aec47cc,444957,1587866,130064604848
160385449,1702657995,1702657691,-304,0xad8663715b08f41a3aec47cc,444958,1595630,130064604848
160385450,1702657995,1702657691,-304,0xad8663715b08f41a3aec47cc,444959,1517590,130064604848
160385451,1702657995,1702657691,-304,0xad8663715b08f41a3aec47cc,444960,1548606,130064604848
160385452,1702657995,1702657691,-304,0xad8663715b08f41a3aec47cc,444961,1588918,130064604848
160385453,1702657995,1702657691,-304,0xad8663715b08f41a3aec47cc,444962,1552122,130064604848
160385454,1702657995,1702657715,-280,0xad8663715b08f41a3aec47cc,444963,1578634,143484171289
160385455,1702657995,1702657715,-280,0xad8663715b08f41a3aec47cc,444964,1534466,143484171289
160385456,1702657995,1702657715,-280,0xad8663715b08f41a3aec47cc,444965,1545636,143484171289
160385457,1702657995,1702657727,-268,0xad8663715b08f41a3aec47cc,444966,1601744,142143878471
160385458,1702657995,1702657727,-268,0xad8663715b08f41a3aec47cc,444967,1593840,142143878471
160385459,1702657995,1702657727,-268,0xad8663715b08f41a3aec47cc,444968,1584980,142143878471
160385460,1702657995,1702657727,-268,0xad8663715b08f41a3aec47cc,444969,1580986,142143878471
160385461,1702657995,1702657739,-256,0xad8663715b08f41a3aec47cc,444970,1604220,138783671810
160385462,1702657995,1702657739,-256,0xad8663715b08f41a3aec47cc,444971,1599284,138783671810
160385463,1702657995,1702657739,-256,0xad8663715b08f41a3aec47cc,444972,1533094,138783671810
160385464,1702657995,1702657739,-256,0xad8663715b08f41a3aec47cc,444973,1559060,138783671810
160385465,1702657995,1702657739,-256,0xad8663715b08f41a3aec47cc,444974,1547224,138783671810
160385466,1702657995,1702657739,-256,0xad8663715b08f41a3aec47cc,444975,1549596,138783671810
160385467,1702657995,1702657739,-256,0xad8663715b08f41a3aec47cc,444976,1563622,138783671810
160385468,1702657995,1702657739,-256,0xad8663715b08f41a3aec47cc,444977,1569490,138783671810
160385469,1702657995,1702657739,-256,0xad8663715b08f41a3aec47cc,444978,1527810,138783671810
160385470,1702657995,1702657739,-256,0xad8663715b08f41a3aec47cc,444979,1583086,138783671810
160385471,1702657995,1702657739,-256,0xad8663715b08f41a3aec47cc,444980,1576838,138783671810
160385473,1702658170,1702657763,-407,0xad8663715b08f41a3aec47cc,444981,1596096,142298308456
160385474,1702658170,1702657763,-407,0xad8663715b08f41a3aec47cc,444982,1565838,142298308456
160385475,1702658170,1702657763,-407,0xad8663715b08f41a3aec47cc,444983,1570502,142298308456
160385476,1702658170,1702657763,-407,0xad8663715b08f41a3aec47cc,444984,1589760,142298308456
160385477,1702658170,1702657763,-407,0xad8663715b08f41a3aec47cc,444985,1562270,142298308456
160385478,1702658170,1702657763,-407,0xad8663715b08f41a3aec47cc,444986,1598972,142298308456
160385479,1702658170,1702657763,-407,0xad8663715b08f41a3aec47cc,444987,1577462,142298308456
160385480,1702658170,1702657763,-407,0xad8663715b08f41a3aec47cc,444988,1541390,142298308456
160385481,1702658170,1702657763,-407,0xad8663715b08f41a3aec47cc,444989,1532336,142298308456
160385482,1702658170,1702657763,-407,0xad8663715b08f41a3aec47cc,444990,1540860,142298308456
160385483,1702658170,1702657763,-407,0xad8663715b08f41a3aec47cc,444991,1514810,142298308456
160385484,1702658170,1702657787,-383,0xad8663715b08f41a3aec47cc,444992,1606824,142029094617
160385485,1702658170,1702657787,-383,0xad8663715b08f41a3aec47cc,444993,1581678,142029094617
160385486,1702658170,1702657787,-383,0xad8663715b08f41a3aec47cc,444994,1581246,142029094617
160385487,1702658170,1702657787,-383,0xad8663715b08f41a3aec47cc,444995,1558740,142029094617
160385488,1702658170,1702657787,-383,0xad8663715b08f41a3aec47cc,444996,1574402,142029094617
160385489,1702658170,1702657787,-383,0xad8663715b08f41a3aec47cc,444997,1572048,142029094617
160385490,1702658170,1702657787,-383,0xad8663715b08f41a3aec47cc,444998,1586880,142029094617
160385491,1702658170,1702657787,-383,0xad8663715b08f41a3aec47cc,444999,1547296,142029094617
160385492,1702658170,1702657787,-383,0xad8663715b08f41a3aec47cc,445000,1573844,142029094617
160385493,1702658170,1702657787,-383,0xad8663715b08f41a3aec47cc,445001,1596004,142029094617
160385494,1702658170,1702657787,-383,0xad8663715b08f41a3aec47cc,445002,1553898,142029094617
160385495,1702658170,1702657787,-383,0xad8663715b08f41a3aec47cc,445003,1596098,142029094617
160385496,1702658170,1702657787,-383,0xad8663715b08f41a3aec47cc,445004,1589672,142029094617
160385497,1702658170,1702657787,-383,0xad8663715b08f41a3aec47cc,445005,1578270,142029094617
160385498,1702658170,1702657823,-347,0xad8663715b08f41a3aec47cc,445006,1576914,142170413960
160385499,1702658170,1702657823,-347,0xad8663715b08f41a3aec47cc,445007,1547884,142170413960
160385500,1702658170,1702657835,-335,0xad8663715b08f41a3aec47cc,445008,1613278,138658198142
160385501,1702658170,1702657835,-335,0xad8663715b08f41a3aec47cc,445009,1597286,138658198142
160385502,1702658170,1702657835,-335,0xad8663715b08f41a3aec47cc,445010,1579388,138658198142
160385503,1702658170,1702657835,-335,0xad8663715b08f41a3aec47cc,445011,1588772,138658198142
160385504,1702658170,1702657835,-335,0xad8663715b08f41a3aec47cc,445012,1527994,138658198142
160385505,1702658170,1702657835,-335,0xad8663715b08f41a3aec47cc,445013,1606094,138658198142
160385506,1702658170,1702657835,-335,0xad8663715b08f41a3aec47cc,445014,1559276,138658198142
160385507,1702658170,1702657835,-335,0xad8663715b08f41a3aec47cc,445015,1591248,138658198142
160385508,1702658170,1702657835,-335,0xad8663715b08f41a3aec47cc,445016,1598984,138658198142
160385509,1702658170,1702657835,-335,0xad8663715b08f41a3aec47cc,445017,1508720,138658198142
160385510,1702658170,1702657835,-335,0xad8663715b08f41a3aec47cc,445018,1573744,138658198142
160385511,1702658170,1702657835,-335,0xad8663715b08f41a3aec47cc,445019,1580864,138658198142
160385512,1702658170,1702657835,-335,0xad8663715b08f41a3aec47cc,445020,1583644,138658198142
160385513,1702658170,1702657859,-311,0xad8663715b08f41a3aec47cc,445021,1550504,145557732744
160385514,1702658170,1702657871,-299,0xad8663715b08f41a3aec47cc,445022,1613146,137840187763
160385515,1702658170,1702657871,-299,0xad8663715b08f41a3aec47cc,445023,1581368,137840187763
160385516,1702658170,1702657871,-299,0xad8663715b08f41a3aec47cc,445024,1578890,137840187763
160385517,1702658170,1702657871,-299,0xad8663715b08f41a3aec47cc,445025,1597490,137840187763
160385518,1702658170,1702657871,-299,0xad8663715b08f41a3aec47cc,445026,1530546,137840187763
160385519,1702658170,1702657871,-299,0xad8663715b08f41a3aec47cc,445027,1595022,137840187763
160385520,1702658170,1702657871,-299,0xad8663715b08f41a3aec47cc,445028,1580496,137840187763
160385521,1702658170,1702657871,-299,0xad8663715b08f41a3aec47cc,445029,1608208,137840187763
160385522,1702658170,1702657871,-299,0xad8663715b08f41a3aec47cc,445030,1527726,137840187763
160385523,1702658170,1702657871,-299,0xad8663715b08f41a3aec47cc,445031,1547166,137840187763
160385524,1702658170,1702657871,-299,0xad8663715b08f41a3aec47cc,445032,1602304,137840187763
160385525,1702658170,1702657871,-299,0xad8663715b08f41a3aec47cc,445033,1598048,137840187763
160385526,1702658170,1702657871,-299,0xad8663715b08f41a3aec47cc,445034,1577372,137840187763
160385528,1702658170,1702657907,-263,0xad8663715b08f41a3aec47cc,445035,1564388,140410596372
160385529,1702658170,1702657907,-263,0xad8663715b08f41a3aec47cc,445036,1559360,140410596372
160385530,1702658170,1702657907,-263,0xad8663715b08f41a3aec47cc,445037,1569794,140410596372
160385531,1702658170,1702657907,-263,0xad8663715b08f41a3aec47cc,445038,1578268,140410596372
160385532,1702658170,1702657907,-263,0xad8663715b08f41a3aec47cc,445039,1523592,140410596372
160385533,1702658170,1702657907,-263,0xad8663715b08f41a3aec47cc,445040,1545024,140410596372
160385534,1702658170,1702657907,-263,0xad8663715b08f41a3aec47cc,445041,1603848,140410596372
160385535,1702658170,1702657907,-263,0xad8663715b08f41a3aec47cc,445042,1577790,140410596372
160385536,1702658170,1702657907,-263,0xad8663715b08f41a3aec47cc,445043,1536486,140410596372
160385537,1702658170,1702657907,-263,0xad8663715b08f41a3aec47cc,445044,1613762,140410596372
160385538,1702658170,1702657907,-263,0xad8663715b08f41a3aec47cc,445045,1550996,140410596372
160385539,1702658170,1702657907,-263,0xad8663715b08f41a3aec47cc,445046,1565202,140410596372
160385540,1702658170,1702657907,-263,0xad8663715b08f41a3aec47cc,445047,1568642,140410596372
160385541,1702658170,1702657907,-263,0xad8663715b08f41a3aec47cc,445048,1581988,140410596372
160385542,1702658170,1702657907,-263,0xad8663715b08f41a3aec47cc,445049,1565570,140410596372
160385543,1702658170,1702657943,-227,0xad8663715b08f41a3aec47cc,445050,1578228,144167597040
160385544,1702658170,1702657955,-215,0xad8663715b08f41a3aec47cc,445051,1586998,134031230960
160385545,1702658170,1702657955,-215,0xad8663715b08f41a3aec47cc,445052,1575508,134031230960
160385546,1702658170,1702657955,-215,0xad8663715b08f41a3aec47cc,445053,1614540,134031230960
160385547,1702658170,1702657955,-215,0xad8663715b08f41a3aec47cc,445054,1545466,134031230960
160385548,1702658170,1702657955,-215,0xad8663715b08f41a3aec47cc,445055,1578856,134031230960
160385549,1702658170,1702657955,-215,0xad8663715b08f41a3aec47cc,445056,1601198,134031230960
160385550,1702658170,1702657955,-215,0xad8663715b08f41a3aec47cc,445057,1603624,134031230960
160385551,1702658170,1702657955,-215,0xad8663715b08f41a3aec47cc,445058,1577762,134031230960
160385552,1702658170,1702657955,-215,0xad8663715b08f41a3aec47cc,445059,1527854,134031230960
160385553,1702658170,1702657955,-215,0xad8663715b08f41a3aec47cc,445060,1591138,134031230960
160385554,1702658170,1702657955,-215,0xad8663715b08f41a3aec47cc,445061,1549734,134031230960
160385555,1702658170,1702657955,-215,0xad8663715b08f41a3aec47cc,445062,1558430,134031230960
160385556,1702658170,1702657955,-215,0xad8663715b08f41a3aec47cc,445063,1555686,134031230960
160385558,1702658170,1702657979,-191,0xad8663715b08f41a3aec47cc,445064,1612026,141336498575
160385559,1702658170,1702657979,-191,0xad8663715b08f41a3aec47cc,445065,1593544,141336498575
160385560,1702658170,1702657979,-191,0xad8663715b08f41a3aec47cc,445066,1587866,141336498575
160385561,1702658170,1702657979,-191,0xad8663715b08f41a3aec47cc,445067,1611662,141336498575
160385562,1702658170,1702657979,-191,0xad8663715b08f41a3aec47cc,445068,1582024,141336498575
160385563,1702658170,1702657979,-191,0xad8663715b08f41a3aec47cc,445069,1541590,141336498575
160385564,1702658170,1702657979,-191,0xad8663715b08f41a3aec47cc,445070,1572316,141336498575
160385565,1702658170,1702657979,-191,0xad8663715b08f41a3aec47cc,445071,1609558,141336498575
160385566,1702658170,1702657979,-191,0xad8663715b08f41a3aec47cc,445072,1594848,141336498575
160385567,1702658170,1702657979,-191,0xad8663715b08f41a3aec47cc,445073,1535998,141336498575
160385568,1702658170,1702657979,-191,0xad8663715b08f41a3aec47cc,445074,1608488,141336498575
160385569,1702658170,1702657979,-191,0xad8663715b08f41a3aec47cc,445075,1563354,141336498575
160385570,1702658170,1702657979,-191,0xad8663715b08f41a3aec47cc,445076,1521818,141336498575
160385571,1702658170,1702658003,-167,0xad8663715b08f41a3aec47cc,445077,1525774,147969637067
160385572,1702658170,1702658015,-155,0xad8663715b08f41a3aec47cc,445078,1573818,141904975718
160385573,1702658170,1702658015,-155,0xad8663715b08f41a3aec47cc,445079,1571944,141904975718
160385574,1702658170,1702658015,-155,0xad8663715b08f41a3aec47cc,445080,1546078,141904975718
160385575,1702658170,1702658015,-155,0xad8663715b08f41a3aec47cc,445081,1561636,141904975718
160385576,1702658170,1702658015,-155,0xad8663715b08f41a3aec47cc,445082,1552188,141904975718
160385577,1702658170,1702658015,-155,0xad8663715b08f41a3aec47cc,445083,1562226,141904975718
160385578,1702658170,1702658015,-155,0xad8663715b08f41a3aec47cc,445084,1570084,141904975718
160385579,1702658170,1702658015,-155,0xad8663715b08f41a3aec47cc,445085,1565230,141904975718
160385580,1702658170,1702658015,-155,0xad8663715b08f41a3aec47cc,445086,1579234,141904975718
160385581,1702658170,1702658015,-155,0xad8663715b08f41a3aec47cc,445087,1545428,141904975718
160385582,1702658170,1702658015,-155,0xad8663715b08f41a3aec47cc,445088,1557604,141904975718
160385583,1702658170,1702658015,-155,0xad8663715b08f41a3aec47cc,445089,1595338,141904975718
160385584,1702658170,1702658051,-119,0xad8663715b08f41a3aec47cc,445090,1613130,145441956949
160385585,1702658170,1702658051,-119,0xad8663715b08f41a3aec47cc,445091,1545366,145441956949
160385586,1702658170,1702658063,-107,0xad8663715b08f41a3aec47cc,445092,1574412,138411862398
160385587,1702658170,1702658063,-107,0xad8663715b08f41a3aec47cc,445093,1607140,138411862398
160385588,1702658170,1702658063,-107,0xad8663715b08f41a3aec47cc,445094,1592282,138411862398
160385589,1702658170,1702658063,-107,0xad8663715b08f41a3aec47cc,445095,1611208,138411862398
160385590,1702658170,1702658063,-107,0xad8663715b08f41a3aec47cc,445096,1532332,138411862398
160385591,1702658170,1702658063,-107,0xad8663715b08f41a3aec47cc,445097,1548578,138411862398
160385592,1702658170,1702658063,-107,0xad8663715b08f41a3aec47cc,445098,1590026,138411862398
160385593,1702658170,1702658063,-107,0xad8663715b08f41a3aec47cc,445099,1554652,138411862398
160385594,1702658170,1702658063,-107,0xad8663715b08f41a3aec47cc,445100,1615248,138411862398
160385595,1702658170,1702658063,-107,0xad8663715b08f41a3aec47cc,445101,1553022,138411862398
160385596,1702658170,1702658063,-107,0xad8663715b08f41a3aec47cc,445102,1587962,138411862398
160385597,1702658170,1702658063,-107,0xad8663715b08f41a3aec47cc,445103,1577704,138411862398
160385598,1702658170,1702658063,-107,0xad8663715b08f41a3aec47cc,445104,1608042,138411862398
160385600,1702658170,1702658087,-83,0xad8663715b08f41a3aec47cc,445105,1530308,143747918965
160385601,1702658170,1702658087,-83,0xad8663715b08f41a3aec47cc,445106,1532832,143747918965
160385602,1702658170,1702658111,-59,0xad8663715b08f41a3aec47cc,445107,1595464,136739271064
160385603,1702658170,1702658111,-59,0xad8663715b08f41a3aec47cc,445108,1520422,136739271064
160385604,1702658170,1702658111,-59,0xad8663715b08f41a3aec47cc,445109,1605614,136739271064
160385605,1702658170,1702658111,-59,0xad8663715b08f41a3aec47cc,445110,1589542,136739271064
160385606,1702658170,1702658111,-59,0xad8663715b08f41a3aec47cc,445111,1579762,136739271064
160385607,1702658170,1702658111,-59,0xad8663715b08f41a3aec47cc,445112,1604306,136739271064
160385608,1702658170,1702658111,-59,0xad8663715b08f41a3aec47cc,445113,1558932,136739271064
160385609,1702658170,1702658111,-59,0xad8663715b08f41a3aec47cc,445114,1570156,136739271064
160385610,1702658170,1702658111,-59,0xad8663715b08f41a3aec47cc,445115,1538238,136739271064
160385611,1702658170,1702658111,-59,0xad8663715b08f41a3aec47cc,445116,1599928,136739271064
160385612,1702658170,1702658111,-59,0xad8663715b08f41a3aec47cc,445117,1566140,136739271064
160385613,1702658170,1702658111,-59,0xad8663715b08f41a3aec47cc,445118,1569982,136739271064
160385614,1702658170,1702658111,-59,0xad8663715b08f41a3aec47cc,445119,1552618,136739271064
160385615,1702658170,1702658111,-59,0xad8663715b08f41a3aec47cc,445120,1566294,136739271064
160385616,1702658170,1702658147,-23,0xad8663715b08f41a3aec47cc,445121,1608862,140206382474
160385617,1702658170,1702658147,-23,0xad8663715b08f41a3aec47cc,445122,1550644,140206382474
160385618,1702658170,1702658147,-23,0xad8663715b08f41a3aec47cc,445123,1586250,140206382474
160385619,1702658170,1702658147,-23,0xad8663715b08f41a3aec47cc,445124,1570184,140206382474
160385620,1702658170,1702658147,-23,0xad8663715b08f41a3aec47cc,445125,1582192,140206382474
160385621,1702658170,1702658147,-23,0xad8663715b08f41a3aec47cc,445126,1592686,140206382474
160385622,1702658170,1702658147,-23,0xad8663715b08f41a3aec47cc,445127,1565912,140206382474
160385623,1702658170,1702658147,-23,0xad8663715b08f41a3aec47cc,445128,1550636,140206382474
160385624,1702658170,1702658147,-23,0xad8663715b08f41a3aec47cc,445129,1594932,140206382474
160385625,1702658170,1702658147,-23,0xad8663715b08f41a3aec47cc,445130,1598242,140206382474
160385626,1702658170,1702658147,-23,0xad8663715b08f41a3aec47cc,445131,1539332,140206382474
160385627,1702658170,1702658147,-23,0xad8663715b08f41a3aec47cc,445132,1597972,140206382474
160385628,1702658170,1702658147,-23,0xad8663715b08f41a3aec47cc,445133,1553340,140206382474
160385629,1702658170,1702658147,-23,0xad8663715b08f41a3aec47cc,445134,1538890,140206382474
160385630,1702658170,1702658147,-23,0xad8663715b08f41a3aec47cc,445135,1601346,140206382474
160385631,1702658183,1702658183,0,0xad8663715b08f41a3aec47cc,445136,1574468,145859110250
160385632,1702658207,1702658207,0,0xad8663715b08f41a3aec47cc,445137,1594608,154511230586
160385633,1702658231,1702658231,0,0xad8663715b08f41a3aec47cc,445138,1554130,144275350697
160385634,1702658231,1702658231,0,0xad8663715b08f41a3aec47cc,445139,1539848,144275350697
160385635,1702658243,1702658243,0,0xad8663715b08f41a3aec47cc,445140,1586032,142311424127
160385636,1702658243,1702658243,0,0xad8663715b08f41a3aec47cc,445141,1542490,142311424127
160385637,1702658243,1702658243,0,0xad8663715b08f41a3aec47cc,445142,1505642,142311424127
160385638,1702658243,1702658243,0,0xad8663715b08f41a3aec47cc,445143,1563616,142311424127
160385639,1702658243,1702658243,0,0xad8663715b08f41a3aec47cc,445144,1595336,142311424127
160385640,1702658267,1702658267,0,0xad8663715b08f41a3aec47cc,445145,1609232,140400838913
160385641,1702658267,1702658267,0,0xad8663715b08f41a3aec47cc,445146,1538658,140400838913
160385642,1702658267,1702658267,0,0xad8663715b08f41a3aec47cc,445147,1555874,140400838913
160385643,1702658267,1702658267,0,0xad8663715b08f41a3aec47cc,445148,1584886,140400838913
160385644,1702658267,1702658267,0,0xad8663715b08f41a3aec47cc,445149,1592634,140400838913
160385645,1702658267,1702658267,0,0xad8663715b08f41a3aec47cc,445150,1524968,140400838913
160385646,1702658267,1702658267,0,0xad8663715b08f41a3aec47cc,445151,1560418,140400838913
160385647,1702658267,1702658267,0,0xad8663715b08f41a3aec47cc,445152,1599428,140400838913
160385648,1702658267,1702658267,0,0xad8663715b08f41a3aec47cc,445153,1575712,140400838913
160385649,1702658267,1702658267,0,0xad8663715b08f41a3aec47cc,445154,1503996,140400838913
160385650,1702658267,1702658267,0,0xad8663715b08f41a3aec47cc,445155,1522146,140400838913
160385651,1702658267,1702658267,0,0xad8663715b08f41a3aec47cc,445156,1541052,140400838913
160385652,1702658267,1702658267,0,0xad8663715b08f41a3aec47cc,445157,1552242,140400838913
160385653,1702658267,1702658267,0,0xad8663715b08f41a3aec47cc,445158,1583380,140400838913
160385654,1702658267,1702658267,0,0xad8663715b08f41a3aec47cc,445159,1508260,140400838913
160385655,1702658303,1702658303,0,0xad8663715b08f41a3aec47cc,445160,1554434,156699502478
160385656,1702658327,1702658327,0,0xad8663715b08f41a3aec47cc,445161,1518842,142321057016
160385657,1702658327,1702658327,0,0xad8663715b08f41a3aec47cc,445162,1514368,142321057016
160385658,1702658327,1702658327,0,0xad8663715b08f41a3aec47cc,445163,1599764,142321057016
160385659,1702658327,1702658327,0,0xad8663715b08f41a3aec47cc,445164,1545708,142321057016
160385660,1702658327,1702658327,0,0xad8663715b08f41a3aec47cc,445165,1530006,142321057016
160385661,1702658327,1702658327,0,0xad8663715b08f41a3aec47cc,445166,1520264,142321057016
160385662,1702658327,1702658327,0,0xad8663715b08f41a3aec47cc,445167,1543532,142321057016
160385663,1702658327,1702658327,0,0xad8663715b08f41a3aec47cc,445168,1577514,142321057016
160385664,1702658327,1702658327,0,0xad8663715b08f41a3aec47cc,445169,1581996,142321057016
160385665,1702658327,1702658327,0,0xad8663715b08f41a3aec47cc,445170,1539676,142321057016
160385666,1702658327,1702658327,0,0xad8663715b08f41a3aec47cc,445171,1511490,142321057016
160385667,1702658363,1702658363,0,0xad8663715b08f41a3aec47cc,445172,1609446,167083484884
160385668,1702658387,1702658387,0,0xad8663715b08f41a3aec47cc,445173,1599956,156740418288
160385669,1702658423,1702658423,0,0xad8663715b08f41a3aec47cc,445174,1566648,159863002047
160385671,1702658459,1702658459,0,0xad8663715b08f41a3aec47cc,445175,1594312,142202392053
160385672,1702658459,1702658459,0,0xad8663715b08f41a3aec47cc,445176,1546428,142202392053
160385673,1702658459,1702658459,0,0xad8663715b08f41a3aec47cc,445177,1561970,142202392053
160385674,1702658495,1702658495,0,0xad8663715b08f41a3aec47cc,445178,1605642,137685348959
160385675,1702658495,1702658495,0,0xad8663715b08f41a3aec47cc,445179,1606278,137685348959
160385676,1702658495,1702658495,0,0xad8663715b08f41a3aec47cc,445180,1535960,137685348959
160385677,1702658495,1702658495,0,0xad8663715b08f41a3aec47cc,445181,1571646,137685348959
160385678,1702658495,1702658495,0,0xad8663715b08f41a3aec47cc,445182,1592142,137685348959
160385679,1702658495,1702658495,0,0xad8663715b08f41a3aec47cc,445183,1601792,137685348959
160385680,1702658495,1702658495,0,0xad8663715b08f41a3aec47cc,445184,1538918,137685348959
160385681,1702658495,1702658495,0,0xad8663715b08f41a3aec47cc,445185,1593712,137685348959
160385682,1702658495,1702658495,0,0xad8663715b08f41a3aec47cc,445186,1607060,137685348959
160385683,1702658495,1702658495,0,0xad8663715b08f41a3aec47cc,445187,1529104,137685348959
160385684,1702658495,1702658495,0,0xad8663715b08f41a3aec47cc,445188,1604492,137685348959
160385685,1702658519,1702658519,0,0xad8663715b08f41a3aec47cc,445189,1489590,151985644549
160385686,1702658555,1702658555,0,0xad8663715b08f41a3aec47cc,445190,1609878,141262761042
160385687,1702658555,1702658555,0,0xad8663715b08f41a3aec47cc,445191,1548666,141262761042
160385688,1702658555,1702658555,0,0xad8663715b08f41a3aec47cc,445192,1593162,141262761042
160385689,1702658555,1702658555,0,0xad8663715b08f41a3aec47cc,445193,1601164,141262761042
160385690,1702658555,1702658555,0,0xad8663715b08f41a3aec47cc,445194,1608288,141262761042
160385691,1702658555,1702658555,0,0xad8663715b08f41a3aec47cc,445195,1561896,141262761042
160385692,1702658555,1702658555,0,0xad8663715b08f41a3aec47cc,445196,1602044,141262761042
160385693,1702658555,1702658555,0,0xad8663715b08f41a3aec47cc,445197,1529394,141262761042
160385694,1702658555,1702658555,0,0xad8663715b08f41a3aec47cc,445198,1606746,141262761042
160385695,1702658555,1702658555,0,0xad8663715b08f41a3aec47cc,445199,1530568,141262761042
160385696,1702658555,1702658555,0,0xad8663715b08f41a3aec47cc,445200,1544124,141262761042
160385697,1702658555,1702658555,0,0xad8663715b08f41a3aec47cc,445201,1600706,141262761042
160385698,1702658555,1702658555,0,0xad8663715b08f41a3aec47cc,445202,1559604,141262761042
160385700,1702658591,1702658591,0,0xad8663715b08f41a3aec47cc,445203,1584706,165518867026
160385701,1702658627,1702658627,0,0xad8663715b08f41a3aec47cc,445204,1568856,146167922879
160385702,1702658651,1702658651,0,0xad8663715b08f41a3aec47cc,445205,1615564,138723838033
160385703,1702658651,1702658651,0,0xad8663715b08f41a3aec47cc,445206,1587406,138723838033
160385704,1702658651,1702658651,0,0xad8663715b08f41a3aec47cc,445207,1561850,138723838033
160385705,1702658651,1702658651,0,0xad8663715b08f41a3aec47cc,445208,1593774,138723838033
160385706,1702658651,1702658651,0,0xad8663715b08f41a3aec47cc,445209,1575960,138723838033
160385707,1702658651,1702658651,0,0xad8663715b08f41a3aec47cc,445210,1529668,138723838033
160385708,1702658651,1702658651,0,0xad8663715b08f41a3aec47cc,445211,1604392,138723838033
160385709,1702658651,1702658651,0,0xad8663715b08f41a3aec47cc,445212,1576618,138723838033
160385710,1702658651,1702658651,0,0xad8663715b08f41a3aec47cc,445213,1562146,138723838033
160385711,1702658651,1702658651,0,0xad8663715b08f41a3aec47cc,445214,1548840,138723838033
160385712,1702658651,1702658651,0,0xad8663715b08f41a3aec47cc,445215,1553132,138723838033
160385713,1702658651,1702658651,0,0xad8663715b08f41a3aec47cc,445216,1570092,138723838033
160385714,1702658675,1702658675,0,0xad8663715b08f41a3aec47cc,445217,1538952,144700464763
160385715,1702658711,1702658711,0,0xad8663715b08f41a3aec47cc,445218,1608702,135114740644
160385716,1702658711,1702658711,0,0xad8663715b08f41a3aec47cc,445219,1583272,135114740644
160385717,1702658711,1702658711,0,0xad8663715b08f41a3aec47cc,445220,1563814,135114740644
160385718,1702658711,1702658711,0,0xad8663715b08f41a3aec47cc,445221,1583970,135114740644
160385719,1702658711,1702658711,0,0xad8663715b08f41a3aec47cc,445222,1573712,135114740644
160385720,1702658711,1702658711,0,0xad8663715b08f41a3aec47cc,445223,1556030,135114740644
160385721,1702658711,1702658711,0,0xad8663715b08f41a3aec47cc,445224,1525270,135114740644
160385722,1702658711,1702658711,0,0xad8663715b08f41a3aec47cc,445225,1604720,135114740644
160385723,1702658711,1702658711,0,0xad8663715b08f41a3aec47cc,445226,1516822,135114740644
160385724,1702658711,1702658711,0,0xad8663715b08f41a3aec47cc,445227,1563442,135114740644
160385725,1702658711,1702658711,0,0xad8663715b08f41a3aec47cc,445228,1594154,135114740644
160385726,1702658735,1702658735,0,0xad8663715b08f41a3aec47cc,445229,1605360,150840903119
160385727,1702658759,1702658759,0,0xad8663715b08f41a3aec47cc,445230,1607346,140437903229
160385728,1702658759,1702658759,0,0xad8663715b08f41a3aec47cc,445231,1475908,140437903229
160385729,1702658759,1702658759,0,0xad8663715b08f41a3aec47cc,445232,1608754,140437903229
160385730,1702658759,1702658759,0,0xad8663715b08f41a3aec47cc,445233,1560652,140437903229
160385731,1702658759,1702658759,0,0xad8663715b08f41a3aec47cc,445234,1607746,140437903229
160385732,1702658759,1702658759,0,0xad8663715b08f41a3aec47cc,445235,1581340,140437903229
160385733,1702658759,1702658759,0,0xad8663715b08f41a3aec47cc,445236,1536774,140437903229
160385734,1702658759,1702658759,0,0xad8663715b08f41a3aec47cc,445237,1530478,140437903229
160385735,1702658759,1702658759,0,0xad8663715b08f41a3aec47cc,445238,1574918,140437903229
160385736,1702658759,1702658759,0,0xad8663715b08f41a3aec47cc,445239,1542162,140437903229
160385737,1702658759,1702658759,0,0xad8663715b08f41a3aec47cc,445240,1527024,140437903229
160385738,1702658759,1702658759,0,0xad8663715b08f41a3aec47cc,445241,1576530,140437903229
160385739,1702658759,1702658759,0,0xad8663715b08f41a3aec47cc,445242,1576602,140437903229
160385740,1702658759,1702658759,0,0xad8663715b08f41a3aec47cc,445243,1564130,140437903229
160385741,1702658759,1702658759,0,0xad8663715b08f41a3aec47cc,445244,1589628,140437903229
160385742,1702658795,1702658795,0,0xad8663715b08f41a3aec47cc,445245,1544698,154042379460
160385743,1702658807,1702658807,0,0xad8663715b08f41a3aec47cc,445246,1507474,149204668264
160385744,1702658819,1702658819,0,0xad8663715b08f41a3aec47cc,445247,1533572,147933803825
160385745,1702658843,1702658843,0,0xad8663715b08f41a3aec47cc,445248,1548656,144644532681
160385746,1702658867,1702658867,0,0xad8663715b08f41a3aec47cc,445249,1591320,142476707917
160385747,1702658867,1702658867,0,0xad8663715b08f41a3aec47cc,445250,1504390,142476707917
160385748,1702658867,1702658867,0,0xad8663715b08f41a3aec47cc,445251,1527276,142476707917
160385749,1702658867,1702658867,0,0xad8663715b08f41a3aec47cc,445252,1555676,142476707917
160385750,1702658867,1702658867,0,0xad8663715b08f41a3aec47cc,445253,1540610,142476707917
160385751,1702658891,1702658891,0,0xad8663715b08f41a3aec47cc,445254,1607928,141602499290
160385752,1702658891,1702658891,0,0xad8663715b08f41a3aec47cc,445255,1545396,141602499290
160385753,1702658891,1702658891,0,0xad8663715b08f41a3aec47cc,445256,1536848,141602499290
160385754,1702658891,1702658891,0,0xad8663715b08f41a3aec47cc,445257,1562250,141602499290
160385755,1702658891,1702658891,0,0xad8663715b08f41a3aec47cc,445258,1604486,141602499290
160385756,1702658891,1702658891,0,0xad8663715b08f41a3aec47cc,445259,1549332,141602499290
160385757,1702658891,1702658891,0,0xad8663715b08f41a3aec47cc,445260,1606584,141602499290
160385964,1702659554,1702658939,-615,0xad8663715b08f41a3aec47cc,445261,1614004,134783265119
160385965,1702659554,1702658939,-615,0xad8663715b08f41a3aec47cc,445262,1533898,134783265119
160385966,1702659554,1702658939,-615,0xad8663715b08f41a3aec47cc,445263,1533314,134783265119
160385967,1702659554,1702658939,-615,0xad8663715b08f41a3aec47cc,445264,1578328,134783265119
160385968,1702659554,1702658939,-615,0xad8663715b08f41a3aec47cc,445265,1607546,134783265119
160385969,1702659554,1702658939,-615,0xad8663715b08f41a3aec47cc,445266,1610652,134783265119
160385970,1702659554,1702658939,-615,0xad8663715b08f41a3aec47cc,445267,1577682,134783265119
160385971,1702659554,1702658939,-615,0xad8663715b08f41a3aec47cc,445268,1507536,134783265119
160385972,1702659554,1702658939,-615,0xad8663715b08f41a3aec47cc,445269,1560886,134783265119
160385973,1702659554,1702658939,-615,0xad8663715b08f41a3aec47cc,445270,1575862,134783265119
160385974,1702659554,1702658939,-615,0xad8663715b08f41a3aec47cc,445271,1610798,134783265119
160385975,1702659554,1702658939,-615,0xad8663715b08f41a3aec47cc,445272,1535652,134783265119
160385976,1702659554,1702658939,-615,0xad8663715b08f41a3aec47cc,445273,1577042,134783265119
160385977,1702659554,1702658939,-615,0xad8663715b08f41a3aec47cc,445274,1576596,134783265119
160385978,1702659554,1702658975,-579,0xad8663715b08f41a3aec47cc,445275,1548962,156092215050
160385979,1702659554,1702659011,-543,0xad8663715b08f41a3aec47cc,445276,1591178,139177179197
160385980,1702659554,1702659011,-543,0xad8663715b08f41a3aec47cc,445277,1573826,139177179197
160385981,1702659554,1702659011,-543,0xad8663715b08f41a3aec47cc,445278,1533872,139177179197
160385982,1702659554,1702659011,-543,0xad8663715b08f41a3aec47cc,445279,1598404,139177179197
160385983,1702659554,1702659011,-543,0xad8663715b08f41a3aec47cc,445280,1604074,139177179197
160385984,1702659554,1702659011,-543,0xad8663715b08f41a3aec47cc,445281,1525738,139177179197
160385985,1702659554,1702659011,-543,0xad8663715b08f41a3aec47cc,445282,1596838,139177179197
160385986,1702659554,1702659011,-543,0xad8663715b08f41a3aec47cc,445283,1522804,139177179197
160385987,1702659554,1702659011,-543,0xad8663715b08f41a3aec47cc,445284,1589254,139177179197
160385988,1702659554,1702659011,-543,0xad8663715b08f41a3aec47cc,445285,1561694,139177179197
160385989,1702659554,1702659011,-543,0xad8663715b08f41a3aec47cc,445286,1509628,139177179197
160385990,1702659554,1702659011,-543,0xad8663715b08f41a3aec47cc,445287,1558744,139177179197
160385992,1702659554,1702659047,-507,0xad8663715b08f41a3aec47cc,445288,1534264,147910811392
160385993,1702659554,1702659071,-483,0xad8663715b08f41a3aec47cc,445289,1600764,139352299587
160385994,1702659554,1702659071,-483,0xad8663715b08f41a3aec47cc,445290,1533174,139352299587
160385995,1702659554,1702659071,-483,0xad8663715b08f41a3aec47cc,445291,1533938,139352299587
160385996,1702659554,1702659071,-483,0xad8663715b08f41a3aec47cc,445292,1603024,139352299587
160385997,1702659554,1702659071,-483,0xad8663715b08f41a3aec47cc,445293,1610860,139352299587
160385998,1702659554,1702659071,-483,0xad8663715b08f41a3aec47cc,445294,1556134,139352299587
160385999,1702659554,1702659071,-483,0xad8663715b08f41a3aec47cc,445295,1538364,139352299587
160386000,1702659554,1702659071,-483,0xad8663715b08f41a3aec47cc,445296,1561458,139352299587
160386001,1702659554,1702659107,-447,0xad8663715b08f41a3aec47cc,445297,1570790,149800894945
160386002,1702659554,1702659131,-423,0xad8663715b08f41a3aec47cc,445298,1541452,141367852304
160386003,1702659554,1702659131,-423,0xad8663715b08f41a3aec47cc,445299,1547140,141367852304
160386004,1702659554,1702659131,-423,0xad8663715b08f41a3aec47cc,445300,1603668,141367852304
160386005,1702659554,1702659131,-423,0xad8663715b08f41a3aec47cc,445301,1558890,141367852304
160386006,1702659554,1702659131,-423,0xad8663715b08f41a3aec47cc,445302,1587098,141367852304
160386007,1702659554,1702659131,-423,0xad8663715b08f41a3aec47cc,445303,1548836,141367852304
160386008,1702659554,1702659131,-423,0xad8663715b08f41a3aec47cc,445304,1559198,141367852304
160386009,1702659554,1702659131,-423,0xad8663715b08f41a3aec47cc,445305,1459714,141367852304
160386010,1702659554,1702659131,-423,0xad8663715b08f41a3aec47cc,445306,1604492,141367852304
160386011,1702659554,1702659131,-423,0xad8663715b08f41a3aec47cc,445307,1541064,141367852304
160386012,1702659554,1702659155,-399,0xad8663715b08f41a3aec47cc,445308,1557310,149070630652
160386013,1702659554,1702659179,-375,0xad8663715b08f41a3aec47cc,445309,1551844,147668558792
160386014,1702659554,1702659191,-363,0xad8663715b08f41a3aec47cc,445310,1544280,146708156942
160386015,1702659554,1702659215,-339,0xad8663715b08f41a3aec47cc,445311,1600836,142186298343
160386016,1702659554,1702659215,-339,0xad8663715b08f41a3aec47cc,445312,1598580,142186298343
160386017,1702659554,1702659215,-339,0xad8663715b08f41a3aec47cc,445313,1554816,142186298343
160386018,1702659554,1702659215,-339,0xad8663715b08f41a3aec47cc,445314,1541980,142186298343
160386019,1702659554,1702659215,-339,0xad8663715b08f41a3aec47cc,445315,1580796,142186298343
160386020,1702659554,1702659215,-339,0xad8663715b08f41a3aec47cc,445316,1556570,142186298343
160386021,1702659554,1702659215,-339,0xad8663715b08f41a3aec47cc,445317,1507700,142186298343
160386022,1702659554,1702659215,-339,0xad8663715b08f41a3aec47cc,445318,1535108,142186298343
160386023,1702659554,1702659215,-339,0xad8663715b08f41a3aec47cc,445319,1528690,142186298343
160386024,1702659554,1702659215,-339,0xad8663715b08f41a3aec47cc,445320,1576782,142186298343
160386025,1702659554,1702659215,-339,0xad8663715b08f41a3aec47cc,445321,1547814,142186298343
160386026,1702659554,1702659251,-303,0xad8663715b08f41a3aec47cc,445322,1606376,148500235180
160386027,1702659554,1702659275,-279,0xad8663715b08f41a3aec47cc,445323,1541864,143025632636
160386028,1702659554,1702659275,-279,0xad8663715b08f41a3aec47cc,445324,1560680,143025632636
160386029,1702659554,1702659275,-279,0xad8663715b08f41a3aec47cc,445325,1518930,143025632636
160386030,1702659554,1702659275,-279,0xad8663715b08f41a3aec47cc,445326,1550296,143025632636
160386031,1702659554,1702659275,-279,0xad8663715b08f41a3aec47cc,445327,1562332,143025632636
160386032,1702659554,1702659275,-279,0xad8663715b08f41a3aec47cc,445328,1519898,143025632636
160386033,1702659554,1702659275,-279,0xad8663715b08f41a3aec47cc,445329,1518968,143025632636
160386034,1702659554,1702659275,-279,0xad8663715b08f41a3aec47cc,445330,1553254,143025632636
160386169,1702659922,1702659311,-611,0xad8663715b08f41a3aec47cc,445331,1592576,145479384456
160386170,1702659922,1702659335,-587,0xad8663715b08f41a3aec47cc,445332,1589480,144764378398
160386171,1702659922,1702659359,-563,0xad8663715b08f41a3aec47cc,445333,1586840,135914319424
160386172,1702659922,1702659359,-563,0xad8663715b08f41a3aec47cc,445334,1495108,135914319424
160386173,1702659922,1702659359,-563,0xad8663715b08f41a3aec47cc,445335,1545826,135914319424
160386174,1702659922,1702659359,-563,0xad8663715b08f41a3aec47cc,445336,1603902,135914319424
160386175,1702659922,1702659359,-563,0xad8663715b08f41a3aec47cc,445337,1563958,135914319424
160386176,1702659922,1702659359,-563,0xad8663715b08f41a3aec47cc,445338,1591752,135914319424
160386177,1702659922,1702659359,-563,0xad8663715b08f41a3aec47cc,445339,1573130,135914319424
160386178,1702659922,1702659359,-563,0xad8663715b08f41a3aec47cc,445340,1599034,135914319424
160386179,1702659922,1702659359,-563,0xad8663715b08f41a3aec47cc,445341,1593130,135914319424
160386180,1702659922,1702659359,-563,0xad8663715b08f41a3aec47cc,445342,1563292,135914319424
160386181,1702659922,1702659359,-563,0xad8663715b08f41a3aec47cc,445343,1557668,135914319424
160386182,1702659922,1702659395,-527,0xad8663715b08f41a3aec47cc,445344,1535002,140454539350
160386183,1702659922,1702659395,-527,0xad8663715b08f41a3aec47cc,445345,1610050,140454539350
160386184,1702659922,1702659395,-527,0xad8663715b08f41a3aec47cc,445346,1612284,140454539350
160386185,1702659922,1702659395,-527,0xad8663715b08f41a3aec47cc,445347,1599044,140454539350
160386186,1702659922,1702659395,-527,0xad8663715b08f41a3aec47cc,445348,1549182,140454539350
160386187,1702659922,1702659395,-527,0xad8663715b08f41a3aec47cc,445349,1514242,140454539350
160386188,1702659922,1702659395,-527,0xad8663715b08f41a3aec47cc,445350,1561608,140454539350
160386189,1702659922,1702659395,-527,0xad8663715b08f41a3aec47cc,445351,1588540,140454539350
160386190,1702659922,1702659395,-527,0xad8663715b08f41a3aec47cc,445352,1566330,140454539350
160386191,1702659922,1702659395,-527,0xad8663715b08f41a3aec47cc,445353,1520172,140454539350
160386192,1702659922,1702659395,-527,0xad8663715b08f41a3aec47cc,445354,1567406,140454539350
160386193,1702659922,1702659395,-527,0xad8663715b08f41a3aec47cc,445355,1507466,140454539350
160386195,1702659922,1702659431,-491,0xad8663715b08f41a3aec47cc,445356,1534056,147602111864
160386196,1702659922,1702659431,-491,0xad8663715b08f41a3aec47cc,445357,1499984,147602111864
160386197,1702659922,1702659479,-443,0xad8663715b08f41a3aec47cc,445358,1561056,144086992020
160386198,1702659922,1702659479,-443,0xad8663715b08f41a3aec47cc,445359,1556096,144086992020
160386199,1702659922,1702659515,-407,0xad8663715b08f41a3aec47cc,445360,1582564,149784360213
160386200,1702659922,1702659539,-383,0xad8663715b08f41a3aec47cc,445361,1598934,170080411342
160386201,1702659922,1702659575,-347,0xad8663715b08f41a3aec47cc,445362,1587120,175694568755
160386202,1702659922,1702659611,-311,0xad8663715b08f41a3aec47cc,445363,1556974,156985800853
160386203,1702659922,1702659635,-287,0xad8663715b08f41a3aec47cc,445364,1558836,160485592575
160386205,1702659922,1702659671,-251,0xad8663715b08f41a3aec47cc,445365,1554994,159929079212
160386263,1702660327,1702659695,-632,0xad8663715b08f41a3aec47cc,445366,1524448,152062488318
160386264,1702660327,1702659719,-608,0xad8663715b08f41a3aec47cc,445367,1566112,147646285225
160386265,1702660327,1702659743,-584,0xad8663715b08f41a3aec47cc,445368,1597328,142251847246
160386266,1702660327,1702659743,-584,0xad8663715b08f41a3aec47cc,445369,1592510,142251847246
160386267,1702660327,1702659767,-560,0xad8663715b08f41a3aec47cc,445370,1608416,138567347412
160386268,1702660327,1702659767,-560,0xad8663715b08f41a3aec47cc,445371,1604806,138567347412
160386269,1702660327,1702659767,-560,0xad8663715b08f41a3aec47cc,445372,1610822,138567347412
160386270,1702660327,1702659767,-560,0xad8663715b08f41a3aec47cc,445373,1540240,138567347412
160386271,1702660327,1702659767,-560,0xad8663715b08f41a3aec47cc,445374,1526292,138567347412
160386272,1702660327,1702659767,-560,0xad8663715b08f41a3aec47cc,445375,1582938,138567347412
160386273,1702660327,1702659767,-560,0xad8663715b08f41a3aec47cc,445376,1508208,138567347412
160386274,1702660327,1702659767,-560,0xad8663715b08f41a3aec47cc,445377,1507834,138567347412
160386275,1702660327,1702659767,-560,0xad8663715b08f41a3aec47cc,445378,1514824,138567347412
160386276,1702660327,1702659767,-560,0xad8663715b08f41a3aec47cc,445379,1566482,138567347412
160386277,1702660327,1702659767,-560,0xad8663715b08f41a3aec47cc,445380,1524176,138567347412
160386278,1702660327,1702659767,-560,0xad8663715b08f41a3aec47cc,445381,1594512,138567347412
160386279,1702660327,1702659767,-560,0xad8663715b08f41a3aec47cc,445382,1551394,138567347412
160386280,1702660327,1702659803,-524,0xad8663715b08f41a3aec47cc,445383,1544460,144572877233
160386281,1702660327,1702659803,-524,0xad8663715b08f41a3aec47cc,445384,1516678,144572877233
160386282,1702660327,1702659815,-512,0xad8663715b08f41a3aec47cc,445385,1608898,140386100924
160386283,1702660327,1702659815,-512,0xad8663715b08f41a3aec47cc,445386,1562368,140386100924
160386284,1702660327,1702659815,-512,0xad8663715b08f41a3aec47cc,445387,1582978,140386100924
160386285,1702660327,1702659815,-512,0xad8663715b08f41a3aec47cc,445388,1593078,140386100924
160386286,1702660327,1702659815,-512,0xad8663715b08f41a3aec47cc,445389,1612356,140386100924
160386287,1702660327,1702659815,-512,0xad8663715b08f41a3aec47cc,445390,1518256,140386100924
160386288,1702660327,1702659815,-512,0xad8663715b08f41a3aec47cc,445391,1586746,140386100924
160386289,1702660327,1702659815,-512,0xad8663715b08f41a3aec47cc,445392,1551036,140386100924
160386290,1702660327,1702659815,-512,0xad8663715b08f41a3aec47cc,445393,1611090,140386100924
160386291,1702660327,1702659815,-512,0xad8663715b08f41a3aec47cc,445394,1548050,140386100924
160386292,1702660327,1702659815,-512,0xad8663715b08f41a3aec47cc,445395,1545158,140386100924
160386293,1702660327,1702659815,-512,0xad8663715b08f41a3aec47cc,445396,1592018,140386100924
160386294,1702660327,1702659851,-476,0xad8663715b08f41a3aec47cc,445397,1587682,148499901882
160386295,1702660327,1702659875,-452,0xad8663715b08f41a3aec47cc,445398,1567242,140477991488
160386296,1702660327,1702659875,-452,0xad8663715b08f41a3aec47cc,445399,1530490,140477991488
160386297,1702660327,1702659875,-452,0xad8663715b08f41a3aec47cc,445400,1608480,140477991488
160386298,1702660327,1702659875,-452,0xad8663715b08f41a3aec47cc,445401,1567230,140477991488
160386299,1702660327,1702659875,-452,0xad8663715b08f41a3aec47cc,445402,1608984,140477991488
160386300,1702660327,1702659875,-452,0xad8663715b08f41a3aec47cc,445403,1576974,140477991488
160386301,1702660327,1702659875,-452,0xad8663715b08f41a3aec47cc,445404,1595076,140477991488
160386302,1702660327,1702659875,-452,0xad8663715b08f41a3aec47cc,445405,1540852,140477991488
160386303,1702660327,1702659875,-452,0xad8663715b08f41a3aec47cc,445406,1558704,140477991488
160386304,1702660327,1702659911,-416,0xad8663715b08f41a3aec47cc,445407,1599176,141129692184
160386305,1702660327,1702659911,-416,0xad8663715b08f41a3aec47cc,445408,1538408,141129692184
160386306,1702660327,1702659911,-416,0xad8663715b08f41a3aec47cc,445409,1543538,141129692184
160386307,1702660327,1702659911,-416,0xad8663715b08f41a3aec47cc,445410,1567114,141129692184
160386308,1702660327,1702659911,-416,0xad8663715b08f41a3aec47cc,445411,1575282,141129692184
160386309,1702660327,1702659911,-416,0xad8663715b08f41a3aec47cc,445412,1497796,141129692184
160386310,1702660327,1702659911,-416,0xad8663715b08f41a3aec47cc,445413,1533288,141129692184
160386311,1702660327,1702659911,-416,0xad8663715b08f41a3aec47cc,445414,1550028,141129692184
160386312,1702660327,1702659911,-416,0xad8663715b08f41a3aec47cc,445415,1519704,141129692184
160386313,1702660327,1702659911,-416,0xad8663715b08f41a3aec47cc,445416,1592492,141129692184
160386314,1702660327,1702659911,-416,0xad8663715b08f41a3aec47cc,445417,1574070,141129692184
160386315,1702660327,1702659911,-416,0xad8663715b08f41a3aec47cc,445418,1605086,141129692184
160386316,1702660327,1702659911,-416,0xad8663715b08f41a3aec47cc,445419,1514590,141129692184
160386318,1702660327,1702659935,-392,0xad8663715b08f41a3aec47cc,445420,1537458,151905057052
160386319,1702660327,1702659947,-380,0xad8663715b08f41a3aec47cc,445421,1493166,145814468096
160386320,1702660327,1702659947,-380,0xad8663715b08f41a3aec47cc,445422,1520404,145814468096
160386321,1702660327,1702659983,-344,0xad8663715b08f41a3aec47cc,445423,1615348,136798649709
160386322,1702660327,1702659983,-344,0xad8663715b08f41a3aec47cc,445424,1565130,136798649709
160386323,1702660327,1702659983,-344,0xad8663715b08f41a3aec47cc,445425,1598186,136798649709
160386324,1702660327,1702659983,-344,0xad8663715b08f41a3aec47cc,445426,1584770,136798649709
160386325,1702660327,1702659983,-344,0xad8663715b08f41a3aec47cc,445427,1606412,136798649709
160386326,1702660327,1702659983,-344,0xad8663715b08f41a3aec47cc,445428,1582376,136798649709
160386327,1702660327,1702659983,-344,0xad8663715b08f41a3aec47cc,445429,1499000,136798649709
160386328,1702660327,1702660007,-320,0xad8663715b08f41a3aec47cc,445430,1570476,146456595843
160386329,1702660327,1702660031,-296,0xad8663715b08f41a3aec47cc,445431,1568802,141529506067
160386330,1702660327,1702660055,-272,0xad8663715b08f41a3aec47cc,445432,1616330,138549134234
160386331,1702660327,1702660055,-272,0xad8663715b08f41a3aec47cc,445433,1603422,138549134234
160386332,1702660327,1702660055,-272,0xad8663715b08f41a3aec47cc,445434,1553130,138549134234
160386333,1702660327,1702660055,-272,0xad8663715b08f41a3aec47cc,445435,1609148,138549134234
160386334,1702660327,1702660055,-272,0xad8663715b08f41a3aec47cc,445436,1592258,138549134234
160386335,1702660327,1702660055,-272,0xad8663715b08f41a3aec47cc,445437,1547444,138549134234
160386336,1702660327,1702660055,-272,0xad8663715b08f41a3aec47cc,445438,1558006,138549134234
160386337,1702660327,1702660055,-272,0xad8663715b08f41a3aec47cc,445439,1565416,138549134234
160386338,1702660327,1702660055,-272,0xad8663715b08f41a3aec47cc,445440,1585062,138549134234
160386339,1702660327,1702660055,-272,0xad8663715b08f41a3aec47cc,445441,1555392,138549134234
160386340,1702660327,1702660055,-272,0xad8663715b08f41a3aec47cc,445442,1496800,138549134234
160386341,1702660327,1702660055,-272,0xad8663715b08f41a3aec47cc,445443,1610976,138549134234
160386364,1702660704,1702660079,-625,0xad8663715b08f41a3aec47cc,445444,1540780,175030349563
160386365,1702660704,1702660115,-589,0xad8663715b08f41a3aec47cc,445445,1573964,162048471920
160386366,1702660704,1702660139,-565,0xad8663715b08f41a3aec47cc,445446,1481212,147244998049
160386367,1702660704,1702660151,-553,0xad8663715b08f41a3aec47cc,445447,1553440,144814983171
160386368,1702660704,1702660175,-529,0xad8663715b08f41a3aec47cc,445448,1604032,134702597415
160386369,1702660704,1702660175,-529,0xad8663715b08f41a3aec47cc,445449,1581600,134702597415
160386370,1702660704,1702660175,-529,0xad8663715b08f41a3aec47cc,445450,1611814,134702597415
160386371,1702660704,1702660199,-505,0xad8663715b08f41a3aec47cc,445451,1503026,143780498728
160386372,1702660704,1702660199,-505,0xad8663715b08f41a3aec47cc,445452,1551932,143780498728
160386373,1702660704,1702660199,-505,0xad8663715b08f41a3aec47cc,445453,1529046,143780498728
160386374,1702660704,1702660199,-505,0xad8663715b08f41a3aec47cc,445454,1562126,143780498728
160386375,1702660704,1702660199,-505,0xad8663715b08f41a3aec47cc,445455,1562114,143780498728
160386376,1702660704,1702660199,-505,0xad8663715b08f41a3aec47cc,445456,1546184,143780498728
160386377,1702660704,1702660199,-505,0xad8663715b08f41a3aec47cc,445457,1525200,143780498728
160386378,1702660704,1702660235,-469,0xad8663715b08f41a3aec47cc,445458,1602684,136321714136
160386379,1702660704,1702660235,-469,0xad8663715b08f41a3aec47cc,445459,1602194,136321714136
160386380,1702660704,1702660235,-469,0xad8663715b08f41a3aec47cc,445460,1575262,136321714136
160386381,1702660704,1702660235,-469,0xad8663715b08f41a3aec47cc,445461,1598936,136321714136
160386382,1702660704,1702660235,-469,0xad8663715b08f41a3aec47cc,445462,1541284,136321714136
160386383,1702660704,1702660235,-469,0xad8663715b08f41a3aec47cc,445463,1597836,136321714136
160386384,1702660704,1702660235,-469,0xad8663715b08f41a3aec47cc,445464,1597166,136321714136
160386385,1702660704,1702660235,-469,0xad8663715b08f41a3aec47cc,445465,1577254,136321714136
160386386,1702660704,1702660235,-469,0xad8663715b08f41a3aec47cc,445466,1557738,136321714136
160386387,1702660704,1702660235,-469,0xad8663715b08f41a3aec47cc,445467,1523558,136321714136
160386388,1702660704,1702660235,-469,0xad8663715b08f41a3aec47cc,445468,1526016,136321714136
160386389,1702660704,1702660235,-469,0xad8663715b08f41a3aec47cc,445469,1586410,136321714136
160386390,1702660704,1702660235,-469,0xad8663715b08f41a3aec47cc,445470,1580618,136321714136
160386391,1702660704,1702660295,-409,0xad8663715b08f41a3aec47cc,445471,1596292,139747451254
160386392,1702660704,1702660295,-409,0xad8663715b08f41a3aec47cc,445472,1501156,139747451254
160386393,1702660704,1702660295,-409,0xad8663715b08f41a3aec47cc,445473,1521648,139747451254
160386394,1702660704,1702660295,-409,0xad8663715b08f41a3aec47cc,445474,1590394,139747451254
160386395,1702660704,1702660295,-409,0xad8663715b08f41a3aec47cc,445475,1614172,139747451254
160386396,1702660704,1702660295,-409,0xad8663715b08f41a3aec47cc,445476,1598354,139747451254
160386397,1702660704,1702660295,-409,0xad8663715b08f41a3aec47cc,445477,1615064,139747451254
160386398,1702660704,1702660295,-409,0xad8663715b08f41a3aec47cc,445478,1586754,139747451254
160386399,1702660704,1702660295,-409,0xad8663715b08f41a3aec47cc,445479,1549810,139747451254
160386400,1702660704,1702660295,-409,0xad8663715b08f41a3aec47cc,445480,1514338,139747451254
160386401,1702660704,1702660295,-409,0xad8663715b08f41a3aec47cc,445481,1481710,139747451254
160386402,1702660704,1702660295,-409,0xad8663715b08f41a3aec47cc,445482,1552942,139747451254
160386403,1702660704,1702660295,-409,0xad8663715b08f41a3aec47cc,445483,1570628,139747451254
160386404,1702660704,1702660295,-409,0xad8663715b08f41a3aec47cc,445484,1570004,139747451254
160386405,1702660704,1702660331,-373,0xad8663715b08f41a3aec47cc,445485,1541736,137105157348
160386406,1702660704,1702660331,-373,0xad8663715b08f41a3aec47cc,445486,1591174,137105157348
160386407,1702660704,1702660331,-373,0xad8663715b08f41a3aec47cc,445487,1601980,137105157348
160386408,1702660704,1702660355,-349,0xad8663715b08f41a3aec47cc,445488,1597590,149122776473
160386409,1702660704,1702660367,-337,0xad8663715b08f41a3aec47cc,445489,1577192,144243919139
160386410,1702660704,1702660367,-337,0xad8663715b08f41a3aec47cc,445490,1495352,144243919139
160386411,1702660704,1702660367,-337,0xad8663715b08f41a3aec47cc,445491,1560862,144243919139
160386412,1702660704,1702660379,-325,0xad8663715b08f41a3aec47cc,445492,1606614,140222778516
160386413,1702660704,1702660379,-325,0xad8663715b08f41a3aec47cc,445493,1524706,140222778516
160386414,1702660704,1702660379,-325,0xad8663715b08f41a3aec47cc,445494,1590224,140222778516
160386415,1702660704,1702660379,-325,0xad8663715b08f41a3aec47cc,445495,1601346,140222778516
160386416,1702660704,1702660379,-325,0xad8663715b08f41a3aec47cc,445496,1525098,140222778516
160386417,1702660704,1702660379,-325,0xad8663715b08f41a3aec47cc,445497,1611350,140222778516
160386418,1702660704,1702660379,-325,0xad8663715b08f41a3aec47cc,445498,1593516,140222778516
160386419,1702660704,1702660379,-325,0xad8663715b08f41a3aec47cc,445499,1566876,140222778516
160386420,1702660704,1702660379,-325,0xad8663715b08f41a3aec47cc,445500,1574344,140222778516
160386421,1702660704,1702660379,-325,0xad8663715b08f41a3aec47cc,445501,1500812,140222778516
160386422,1702660704,1702660379,-325,0xad8663715b08f41a3aec47cc,445502,1552388,140222778516
160386423,1702660704,1702660379,-325,0xad8663715b08f41a3aec47cc,445503,1581802,140222778516
160386424,1702660704,1702660415,-289,0xad8663715b08f41a3aec47cc,445504,1606766,141568727209
160386425,1702660704,1702660415,-289,0xad8663715b08f41a3aec47cc,445505,1555530,141568727209
160386426,1702660704,1702660415,-289,0xad8663715b08f41a3aec47cc,445506,1557892,141568727209
160386427,1702660704,1702660415,-289,0xad8663715b08f41a3aec47cc,445507,1609204,141568727209
160386428,1702660704,1702660415,-289,0xad8663715b08f41a3aec47cc,445508,1546592,141568727209
160386429,1702660704,1702660415,-289,0xad8663715b08f41a3aec47cc,445509,1609486,141568727209
160386430,1702660704,1702660415,-289,0xad8663715b08f41a3aec47cc,445510,1589962,141568727209
160386431,1702660704,1702660415,-289,0xad8663715b08f41a3aec47cc,445511,1565688,141568727209
160386432,1702660704,1702660415,-289,0xad8663715b08f41a3aec47cc,445512,1475168,141568727209
160386433,1702660704,1702660415,-289,0xad8663715b08f41a3aec47cc,445513,1591392,141568727209
160386434,1702660704,1702660415,-289,0xad8663715b08f41a3aec47cc,445514,1533340,141568727209
160386435,1702660704,1702660415,-289,0xad8663715b08f41a3aec47cc,445515,1581648,141568727209
160386436,1702660704,1702660415,-289,0xad8663715b08f41a3aec47cc,445516,1592850,141568727209
160386507,1702661091,1702660451,-640,0xad8663715b08f41a3aec47cc,445517,1604390,155838189871
160386508,1702661091,1702660475,-616,0xad8663715b08f41a3aec47cc,445518,1523364,142660080122
160386509,1702661091,1702660475,-616,0xad8663715b08f41a3aec47cc,445519,1589834,142660080122
160386510,1702661091,1702660475,-616,0xad8663715b08f41a3aec47cc,445520,1593846,142660080122
160386511,1702661091,1702660475,-616,0xad8663715b08f41a3aec47cc,445521,1580040,142660080122
160386512,1702661091,1702660475,-616,0xad8663715b08f41a3aec47cc,445522,1549148,142660080122
160386513,1702661091,1702660475,-616,0xad8663715b08f41a3aec47cc,445523,1525388,142660080122
160386514,1702661091,1702660475,-616,0xad8663715b08f41a3aec47cc,445524,1563400,142660080122
160386515,1702661091,1702660475,-616,0xad8663715b08f41a3aec47cc,445525,1547462,142660080122
160386516,1702661091,1702660475,-616,0xad8663715b08f41a3aec47cc,445526,1544494,142660080122
160386517,1702661091,1702660475,-616,0xad8663715b08f41a3aec47cc,445527,1494300,142660080122
160386518,1702661091,1702660475,-616,0xad8663715b08f41a3aec47cc,445528,1546994,142660080122
160386519,1702661091,1702660475,-616,0xad8663715b08f41a3aec47cc,445529,1522292,142660080122
160386520,1702661091,1702660475,-616,0xad8663715b08f41a3aec47cc,445530,1538502,142660080122
160386521,1702661091,1702660475,-616,0xad8663715b08f41a3aec47cc,445531,1539192,142660080122
160386522,1702661091,1702660475,-616,0xad8663715b08f41a3aec47cc,445532,1578728,142660080122
160386523,1702661091,1702660511,-580,0xad8663715b08f41a3aec47cc,445533,1541686,144224075428
160386524,1702661091,1702660523,-568,0xad8663715b08f41a3aec47cc,445534,1604412,140808747164
160386525,1702661091,1702660523,-568,0xad8663715b08f41a3aec47cc,445535,1540402,140808747164
160386526,1702661091,1702660523,-568,0xad8663715b08f41a3aec47cc,445536,1569632,140808747164
160386527,1702661091,1702660523,-568,0xad8663715b08f41a3aec47cc,445537,1547080,140808747164
160386528,1702661091,1702660523,-568,0xad8663715b08f41a3aec47cc,445538,1542918,140808747164
160386529,1702661091,1702660523,-568,0xad8663715b08f41a3aec47cc,445539,1581420,140808747164
160386530,1702661091,1702660523,-568,0xad8663715b08f41a3aec47cc,445540,1592492,140808747164
160386531,1702661091,1702660523,-568,0xad8663715b08f41a3aec47cc,445541,1583798,140808747164
160386532,1702661091,1702660523,-568,0xad8663715b08f41a3aec47cc,445542,1576904,140808747164
160386533,1702661091,1702660523,-568,0xad8663715b08f41a3aec47cc,445543,1577218,140808747164
160386534,1702661091,1702660523,-568,0xad8663715b08f41a3aec47cc,445544,1580270,140808747164
160386535,1702661091,1702660523,-568,0xad8663715b08f41a3aec47cc,445545,1609608,140808747164
160386537,1702661091,1702660559,-532,0xad8663715b08f41a3aec47cc,445546,1597618,140235954221
160386538,1702661091,1702660559,-532,0xad8663715b08f41a3aec47cc,445547,1546558,140235954221
160386539,1702661091,1702660559,-532,0xad8663715b08f41a3aec47cc,445548,1615494,140235954221
160386540,1702661091,1702660559,-532,0xad8663715b08f41a3aec47cc,445549,1513344,140235954221
160386541,1702661091,1702660559,-532,0xad8663715b08f41a3aec47cc,445550,1567572,140235954221
160386542,1702661091,1702660559,-532,0xad8663715b08f41a3aec47cc,445551,1553518,140235954221
160386543,1702661091,1702660559,-532,0xad8663715b08f41a3aec47cc,445552,1535414,140235954221
160386544,1702661091,1702660559,-532,0xad8663715b08f41a3aec47cc,445553,1573152,140235954221
160386546,1702661091,1702660595,-496,0xad8663715b08f41a3aec47cc,445554,1600808,141966084177
160386547,1702661091,1702660595,-496,0xad8663715b08f41a3aec47cc,445555,1552782,141966084177
160386548,1702661091,1702660595,-496,0xad8663715b08f41a3aec47cc,445556,1596050,141966084177
160386549,1702661091,1702660595,-496,0xad8663715b08f41a3aec47cc,445557,1570118,141966084177
160386550,1702661091,1702660619,-472,0xad8663715b08f41a3aec47cc,445558,1610330,140809961381
160386551,1702661091,1702660619,-472,0xad8663715b08f41a3aec47cc,445559,1591242,140809961381
160386552,1702661091,1702660619,-472,0xad8663715b08f41a3aec47cc,445560,1591906,140809961381
160386553,1702661091,1702660619,-472,0xad8663715b08f41a3aec47cc,445561,1555984,140809961381
160386554,1702661091,1702660619,-472,0xad8663715b08f41a3aec47cc,445562,1614380,140809961381
160386555,1702661091,1702660619,-472,0xad8663715b08f41a3aec47cc,445563,1564802,140809961381
160386556,1702661091,1702660619,-472,0xad8663715b08f41a3aec47cc,445564,1556132,140809961381
160386557,1702661091,1702660619,-472,0xad8663715b08f41a3aec47cc,445565,1578670,140809961381
160386558,1702661091,1702660619,-472,0xad8663715b08f41a3aec47cc,445566,1554534,140809961381
160386559,1702661091,1702660619,-472,0xad8663715b08f41a3aec47cc,445567,1531376,140809961381
160386560,1702661091,1702660619,-472,0xad8663715b08f41a3aec47cc,445568,1565484,140809961381
160386561,1702661091,1702660619,-472,0xad8663715b08f41a3aec47cc,445569,1561878,140809961381
160386562,1702661091,1702660619,-472,0xad8663715b08f41a3aec47cc,445570,1503138,140809961381
160386563,1702661091,1702660619,-472,0xad8663715b08f41a3aec47cc,445571,1565152,140809961381
160386565,1702661091,1702660655,-436,0xad8663715b08f41a3aec47cc,445572,1512562,144211234459
160386566,1702661091,1702660667,-424,0xad8663715b08f41a3aec47cc,445573,1610100,136490746619
160386567,1702661091,1702660667,-424,0xad8663715b08f41a3aec47cc,445574,1544114,136490746619
160386568,1702661091,1702660667,-424,0xad8663715b08f41a3aec47cc,445575,1570680,136490746619
160386569,1702661091,1702660667,-424,0xad8663715b08f41a3aec47cc,445576,1566452,136490746619
160386570,1702661091,1702660667,-424,0xad8663715b08f41a3aec47cc,445577,1539152,136490746619
160386571,1702661091,1702660667,-424,0xad8663715b08f41a3aec47cc,445578,1587548,136490746619
160386572,1702661091,1702660667,-424,0xad8663715b08f41a3aec47cc,445579,1575926,136490746619
160386573,1702661091,1702660667,-424,0xad8663715b08f41a3aec47cc,445580,1575614,136490746619
160386574,1702661091,1702660667,-424,0xad8663715b08f41a3aec47cc,445581,1601594,136490746619
160386575,1702661091,1702660667,-424,0xad8663715b08f41a3aec47cc,445582,1540174,136490746619
160386576,1702661091,1702660667,-424,0xad8663715b08f41a3aec47cc,445583,1593004,136490746619
160386577,1702661091,1702660667,-424,0xad8663715b08f41a3aec47cc,445584,1604280,136490746619
160386578,1702661091,1702660667,-424,0xad8663715b08f41a3aec47cc,445585,1602076,136490746619
160386580,1702661091,1702660703,-388,0xad8663715b08f41a3aec47cc,445586,1560578,144686383122
160386581,1702661091,1702660715,-376,0xad8663715b08f41a3aec47cc,445587,1594182,138400782226
160386582,1702661091,1702660715,-376,0xad8663715b08f41a3aec47cc,445588,1542216,138400782226
160386583,1702661091,1702660715,-376,0xad8663715b08f41a3aec47cc,445589,1567330,138400782226
160386584,1702661091,1702660715,-376,0xad8663715b08f41a3aec47cc,445590,1534394,138400782226
160386585,1702661091,1702660715,-376,0xad8663715b08f41a3aec47cc,445591,1614690,138400782226
160386586,1702661091,1702660715,-376,0xad8663715b08f41a3aec47cc,445592,1522372,138400782226
160386587,1702661091,1702660715,-376,0xad8663715b08f41a3aec47cc,445593,1549256,138400782226
160386588,1702661091,1702660715,-376,0xad8663715b08f41a3aec47cc,445594,1585750,138400782226
160386589,1702661091,1702660715,-376,0xad8663715b08f41a3aec47cc,445595,1533744,138400782226
160386590,1702661091,1702660715,-376,0xad8663715b08f41a3aec47cc,445596,1528340,138400782226
160386591,1702661091,1702660715,-376,0xad8663715b08f41a3aec47cc,445597,1587136,138400782226
160386592,1702661091,1702660715,-376,0xad8663715b08f41a3aec47cc,445598,1573972,138400782226
160386593,1702661091,1702660715,-376,0xad8663715b08f41a3aec47cc,445599,1587396,138400782226
160386594,1702661091,1702660715,-376,0xad8663715b08f41a3aec47cc,445600,1567890,138400782226
160386596,1702661091,1702660751,-340,0xad8663715b08f41a3aec47cc,445601,1566130,142984830266
160386597,1702661091,1702660763,-328,0xad8663715b08f41a3aec47cc,445602,1596080,138749307410
160386598,1702661091,1702660763,-328,0xad8663715b08f41a3aec47cc,445603,1597684,138749307410
160386599,1702661091,1702660763,-328,0xad8663715b08f41a3aec47cc,445604,1613536,138749307410
160386600,1702661091,1702660763,-328,0xad8663715b08f41a3aec47cc,445605,1551896,138749307410
160386601,1702661091,1702660763,-328,0xad8663715b08f41a3aec47cc,445606,1573204,138749307410
160386602,1702661091,1702660763,-328,0xad8663715b08f41a3aec47cc,445607,1553714,138749307410
160386603,1702661091,1702660763,-328,0xad8663715b08f41a3aec47cc,445608,1605862,138749307410
160386604,1702661091,1702660763,-328,0xad8663715b08f41a3aec47cc,445609,1581882,138749307410
160386605,1702661091,1702660763,-328,0xad8663715b08f41a3aec47cc,445610,1587530,138749307410
160386606,1702661091,1702660763,-328,0xad8663715b08f41a3aec47cc,445611,1578216,138749307410
160386607,1702661091,1702660763,-328,0xad8663715b08f41a3aec47cc,445612,1571856,138749307410
160386608,1702661091,1702660763,-328,0xad8663715b08f41a3aec47cc,445613,1527078,138749307410
160386609,1702661091,1702660763,-328,0xad8663715b08f41a3aec47cc,445614,1560220,138749307410
160386610,1702661091,1702660763,-328,0xad8663715b08f41a3aec47cc,445615,1597046,138749307410
160386611,1702661091,1702660787,-304,0xad8663715b08f41a3aec47cc,445616,1591604,161244653090
160386612,1702661091,1702660811,-280,0xad8663715b08f41a3aec47cc,445617,1535058,144972932193
160386613,1702661091,1702660823,-268,0xad8663715b08f41a3aec47cc,445618,1584664,142956861280
160386614,1702661091,1702660823,-268,0xad8663715b08f41a3aec47cc,445619,1545982,142956861280
160386615,1702661091,1702660823,-268,0xad8663715b08f41a3aec47cc,445620,1569294,142956861280
160386736,1702661491,1702660835,-656,0xad8663715b08f41a3aec47cc,445621,1595140,138230489437
160386737,1702661491,1702660835,-656,0xad8663715b08f41a3aec47cc,445622,1540274,138230489437
160386738,1702661491,1702660835,-656,0xad8663715b08f41a3aec47cc,445623,1540752,138230489437
160386739,1702661491,1702660835,-656,0xad8663715b08f41a3aec47cc,445624,1604698,138230489437
160386740,1702661491,1702660835,-656,0xad8663715b08f41a3aec47cc,445625,1599792,138230489437
160386741,1702661491,1702660835,-656,0xad8663715b08f41a3aec47cc,445626,1570506,138230489437
160386742,1702661491,1702660835,-656,0xad8663715b08f41a3aec47cc,445627,1599496,138230489437
160386743,1702661491,1702660835,-656,0xad8663715b08f41a3aec47cc,445628,1585134,138230489437
160386744,1702661491,1702660835,-656,0xad8663715b08f41a3aec47cc,445629,1563604,138230489437
160386745,1702661491,1702660835,-656,0xad8663715b08f41a3aec47cc,445630,1596130,138230489437
160386746,1702661491,1702660835,-656,0xad8663715b08f41a3aec47cc,445631,1562204,138230489437
160386747,1702661491,1702660835,-656,0xad8663715b08f41a3aec47cc,445632,1598078,138230489437
160386748,1702661491,1702660871,-620,0xad8663715b08f41a3aec47cc,445633,1569706,140043911972
160386749,1702661491,1702660871,-620,0xad8663715b08f41a3aec47cc,445634,1596846,140043911972
160386750,1702661491,1702660871,-620,0xad8663715b08f41a3aec47cc,445635,1527364,140043911972
160386751,1702661491,1702660871,-620,0xad8663715b08f41a3aec47cc,445636,1571614,140043911972
160386752,1702661491,1702660871,-620,0xad8663715b08f41a3aec47cc,445637,1575782,140043911972
160386753,1702661491,1702660871,-620,0xad8663715b08f41a3aec47cc,445638,1565352,140043911972
160386754,1702661491,1702660871,-620,0xad8663715b08f41a3aec47cc,445639,1588014,140043911972
160386755,1702661491,1702660871,-620,0xad8663715b08f41a3aec47cc,445640,1528686,140043911972
160386756,1702661491,1702660871,-620,0xad8663715b08f41a3aec47cc,445641,1546108,140043911972
160386757,1702661491,1702660871,-620,0xad8663715b08f41a3aec47cc,445642,1541756,140043911972
160386758,1702661491,1702660871,-620,0xad8663715b08f41a3aec47cc,445643,1585328,140043911972
160386759,1702661491,1702660871,-620,0xad8663715b08f41a3aec47cc,445644,1507704,140043911972
160386760,1702661491,1702660871,-620,0xad8663715b08f41a3aec47cc,445645,1590600,140043911972
160386761,1702661491,1702660895,-596,0xad8663715b08f41a3aec47cc,445646,1598142,149755649168
160386762,1702661491,1702660919,-572,0xad8663715b08f41a3aec47cc,445647,1580878,133052382438
160386763,1702661491,1702660919,-572,0xad8663715b08f41a3aec47cc,445648,1609514,133052382438
160386764,1702661491,1702660919,-572,0xad8663715b08f41a3aec47cc,445649,1554368,133052382438
160386765,1702661491,1702660919,-572,0xad8663715b08f41a3aec47cc,445650,1585292,133052382438
160386766,1702661491,1702660919,-572,0xad8663715b08f41a3aec47cc,445651,1554216,133052382438
160386767,1702661491,1702660919,-572,0xad8663715b08f41a3aec47cc,445652,1591316,133052382438
160386768,1702661491,1702660919,-572,0xad8663715b08f41a3aec47cc,445653,1604436,133052382438
160386769,1702661491,1702660919,-572,0xad8663715b08f41a3aec47cc,445654,1601158,133052382438
160386770,1702661491,1702660919,-572,0xad8663715b08f41a3aec47cc,445655,1611644,133052382438
160386771,1702661491,1702660919,-572,0xad8663715b08f41a3aec47cc,445656,1537168,133052382438
160386772,1702661491,1702660919,-572,0xad8663715b08f41a3aec47cc,445657,1581520,133052382438
160386773,1702661491,1702660919,-572,0xad8663715b08f41a3aec47cc,445658,1544632,133052382438
160386774,1702661491,1702660955,-536,0xad8663715b08f41a3aec47cc,445659,1574370,141637657365
160386775,1702661491,1702660955,-536,0xad8663715b08f41a3aec47cc,445660,1498822,141637657365
160386776,1702661491,1702660955,-536,0xad8663715b08f41a3aec47cc,445661,1560994,141637657365
160386777,1702661491,1702660955,-536,0xad8663715b08f41a3aec47cc,445662,1530770,141637657365
160386778,1702661491,1702660955,-536,0xad8663715b08f41a3aec47cc,445663,1606604,141637657365
160386779,1702661491,1702660955,-536,0xad8663715b08f41a3aec47cc,445664,1589062,141637657365
160386780,1702661491,1702660955,-536,0xad8663715b08f41a3aec47cc,445665,1587408,141637657365
160386781,1702661491,1702660955,-536,0xad8663715b08f41a3aec47cc,445666,1538554,141637657365
160386782,1702661491,1702660955,-536,0xad8663715b08f41a3aec47cc,445667,1589636,141637657365
160386783,1702661491,1702660955,-536,0xad8663715b08f41a3aec47cc,445668,1521676,141637657365
160386784,1702661491,1702660955,-536,0xad8663715b08f41a3aec47cc,445669,1588956,141637657365
160386785,1702661491,1702660955,-536,0xad8663715b08f41a3aec47cc,445670,1535866,141637657365
160386786,1702661491,1702660991,-500,0xad8663715b08f41a3aec47cc,445671,1610734,140055754543
160386787,1702661491,1702660991,-500,0xad8663715b08f41a3aec47cc,445672,1551782,140055754543
160386788,1702661491,1702660991,-500,0xad8663715b08f41a3aec47cc,445673,1544532,140055754543
160386789,1702661491,1702660991,-500,0xad8663715b08f41a3aec47cc,445674,1589312,140055754543
160386790,1702661491,1702660991,-500,0xad8663715b08f41a3aec47cc,445675,1607404,140055754543
160386791,1702661491,1702660991,-500,0xad8663715b08f41a3aec47cc,445676,1565006,140055754543
160386792,1702661491,1702660991,-500,0xad8663715b08f41a3aec47cc,445677,1586380,140055754543
160386793,1702661491,1702660991,-500,0xad8663715b08f41a3aec47cc,445678,1588822,140055754543
160386794,1702661491,1702660991,-500,0xad8663715b08f41a3aec47cc,445679,1612934,140055754543
160386795,1702661491,1702660991,-500,0xad8663715b08f41a3aec47cc,445680,1589662,140055754543
160386796,1702661491,1702660991,-500,0xad8663715b08f41a3aec47cc,445681,1605238,140055754543
160386797,1702661491,1702660991,-500,0xad8663715b08f41a3aec47cc,445682,1578878,140055754543
160386798,1702661491,1702660991,-500,0xad8663715b08f41a3aec47cc,445683,1611328,140055754543
160386799,1702661491,1702660991,-500,0xad8663715b08f41a3aec47cc,445684,1589796,140055754543
160386800,1702661491,1702661027,-464,0xad8663715b08f41a3aec47cc,445685,1541118,147084116298
160386801,1702661491,1702661039,-452,0xad8663715b08f41a3aec47cc,445686,1583218,143710326579
160386802,1702661491,1702661039,-452,0xad8663715b08f41a3aec47cc,445687,1541190,143710326579
160386803,1702661491,1702661051,-440,0xad8663715b08f41a3aec47cc,445688,1598580,138847027813
160386804,1702661491,1702661051,-440,0xad8663715b08f41a3aec47cc,445689,1553164,138847027813
160386805,1702661491,1702661051,-440,0xad8663715b08f41a3aec47cc,445690,1576718,138847027813
160386806,1702661491,1702661051,-440,0xad8663715b08f41a3aec47cc,445691,1556626,138847027813
160386807,1702661491,1702661051,-440,0xad8663715b08f41a3aec47cc,445692,1570832,138847027813
160386808,1702661491,1702661051,-440,0xad8663715b08f41a3aec47cc,445693,1588040,138847027813
160386809,1702661491,1702661051,-440,0xad8663715b08f41a3aec47cc,445694,1560196,138847027813
160386810,1702661491,1702661051,-440,0xad8663715b08f41a3aec47cc,445695,1560364,138847027813
160386811,1702661491,1702661051,-440,0xad8663715b08f41a3aec47cc,445696,1566864,138847027813
160386812,1702661491,1702661051,-440,0xad8663715b08f41a3aec47cc,445697,1568364,138847027813
160386813,1702661491,1702661051,-440,0xad8663715b08f41a3aec47cc,445698,1528646,138847027813
160386814,1702661491,1702661051,-440,0xad8663715b08f41a3aec47cc,445699,1469062,138847027813
160386815,1702661491,1702661075,-416,0xad8663715b08f41a3aec47cc,445700,1548792,147805606956
160386816,1702661491,1702661111,-380,0xad8663715b08f41a3aec47cc,445701,1592324,139614029127
160386817,1702661491,1702661111,-380,0xad8663715b08f41a3aec47cc,445702,1525066,139614029127
160386818,1702661491,1702661111,-380,0xad8663715b08f41a3aec47cc,445703,1575676,139614029127
160386819,1702661491,1702661111,-380,0xad8663715b08f41a3aec47cc,445704,1583202,139614029127
160386820,1702661491,1702661111,-380,0xad8663715b08f41a3aec47cc,445705,1540866,139614029127
160386821,1702661491,1702661111,-380,0xad8663715b08f41a3aec47cc,445706,1554772,139614029127
160386822,1702661491,1702661111,-380,0xad8663715b08f41a3aec47cc,445707,1564940,139614029127
160386823,1702661491,1702661111,-380,0xad8663715b08f41a3aec47cc,445708,1535304,139614029127
160386824,1702661491,1702661111,-380,0xad8663715b08f41a3aec47cc,445709,1563484,139614029127
160386825,1702661491,1702661111,-380,0xad8663715b08f41a3aec47cc,445710,1545122,139614029127
160386826,1702661491,1702661111,-380,0xad8663715b08f41a3aec47cc,445711,1554390,139614029127
160386827,1702661491,1702661111,-380,0xad8663715b08f41a3aec47cc,445712,1526376,139614029127
160386829,1702661491,1702661135,-356,0xad8663715b08f41a3aec47cc,445713,1567968,156482865361
160386830,1702661491,1702661147,-344,0xad8663715b08f41a3aec47cc,445714,1545292,146529626660
160386831,1702661491,1702661147,-344,0xad8663715b08f41a3aec47cc,445715,1551200,146529626660
160386833,1702661491,1702661171,-320,0xad8663715b08f41a3aec47cc,445716,1557974,138025349024
160386834,1702661491,1702661171,-320,0xad8663715b08f41a3aec47cc,445717,1557418,138025349024
160386835,1702661491,1702661171,-320,0xad8663715b08f41a3aec47cc,445718,1569608,138025349024
160386836,1702661491,1702661171,-320,0xad8663715b08f41a3aec47cc,445719,1601178,138025349024
160386837,1702661491,1702661171,-320,0xad8663715b08f41a3aec47cc,445720,1551272,138025349024
160386838,1702661491,1702661171,-320,0xad8663715b08f41a3aec47cc,445721,1565498,138025349024
160386839,1702661491,1702661171,-320,0xad8663715b08f41a3aec47cc,445722,1609434,138025349024
160386840,1702661491,1702661171,-320,0xad8663715b08f41a3aec47cc,445723,1510124,138025349024
160386841,1702661491,1702661171,-320,0xad8663715b08f41a3aec47cc,445724,1550674,138025349024
160386842,1702661491,1702661171,-320,0xad8663715b08f41a3aec47cc,445725,1550342,138025349024
160386843,1702661491,1702661171,-320,0xad8663715b08f41a3aec47cc,445726,1573872,138025349024
160386844,1702661491,1702661171,-320,0xad8663715b08f41a3aec47cc,445727,1569296,138025349024
160386845,1702661491,1702661171,-320,0xad8663715b08f41a3aec47cc,445728,1548056,138025349024
160386846,1702661491,1702661171,-320,0xad8663715b08f41a3aec47cc,445729,1614500,138025349024
160386847,1702661491,1702661207,-284,0xad8663715b08f41a3aec47cc,445730,1612516,139418713213
160386848,1702661491,1702661207,-284,0xad8663715b08f41a3aec47cc,445731,1535932,139418713213
160386849,1702661491,1702661207,-284,0xad8663715b08f41a3aec47cc,445732,1535204,139418713213
160386850,1702661491,1702661207,-284,0xad8663715b08f41a3aec47cc,445733,1599236,139418713213
160386851,1702661491,1702661207,-284,0xad8663715b08f41a3aec47cc,445734,1594734,139418713213
160386852,1702661491,1702661207,-284,0xad8663715b08f41a3aec47cc,445735,1558780,139418713213
160386853,1702661491,1702661207,-284,0xad8663715b08f41a3aec47cc,445736,1561994,139418713213
160386854,1702661491,1702661207,-284,0xad8663715b08f41a3aec47cc,445737,1581468,139418713213
160386855,1702661491,1702661207,-284,0xad8663715b08f41a3aec47cc,445738,1606008,139418713213
160386856,1702661491,1702661207,-284,0xad8663715b08f41a3aec47cc,445739,1602688,139418713213
160386857,1702661491,1702661207,-284,0xad8663715b08f41a3aec47cc,445740,1548512,139418713213
160386898,1702661873,1702661231,-642,0xad8663715b08f41a3aec47cc,445741,1597022,137212758299
160386899,1702661873,1702661231,-642,0xad8663715b08f41a3aec47cc,445742,1580274,137212758299
160386900,1702661873,1702661231,-642,0xad8663715b08f41a3aec47cc,445743,1578208,137212758299
160386901,1702661873,1702661231,-642,0xad8663715b08f41a3aec47cc,445744,1547624,137212758299
160386902,1702661873,1702661231,-642,0xad8663715b08f41a3aec47cc,445745,1591524,137212758299
160386903,1702661873,1702661231,-642,0xad8663715b08f41a3aec47cc,445746,1549888,137212758299
160386904,1702661873,1702661231,-642,0xad8663715b08f41a3aec47cc,445747,1608996,137212758299
160386905,1702661873,1702661231,-642,0xad8663715b08f41a3aec47cc,445748,1577444,137212758299
160386906,1702661873,1702661231,-642,0xad8663715b08f41a3aec47cc,445749,1536948,137212758299
160386907,1702661873,1702661231,-642,0xad8663715b08f41a3aec47cc,445750,1584060,137212758299
160386908,1702661873,1702661231,-642,0xad8663715b08f41a3aec47cc,445751,1604726,137212758299
160386909,1702661873,1702661255,-618,0xad8663715b08f41a3aec47cc,445752,1581120,138963707722
160386910,1702661873,1702661255,-618,0xad8663715b08f41a3aec47cc,445753,1604734,138963707722
160386911,1702661873,1702661255,-618,0xad8663715b08f41a3aec47cc,445754,1558014,138963707722
160386912,1702661873,1702661255,-618,0xad8663715b08f41a3aec47cc,445755,1607268,138963707722
160386913,1702661873,1702661255,-618,0xad8663715b08f41a3aec47cc,445756,1544012,138963707722
160386914,1702661873,1702661255,-618,0xad8663715b08f41a3aec47cc,445757,1598774,138963707722
160386915,1702661873,1702661255,-618,0xad8663715b08f41a3aec47cc,445758,1561664,138963707722
160386916,1702661873,1702661255,-618,0xad8663715b08f41a3aec47cc,445759,1554082,138963707722
160386917,1702661873,1702661255,-618,0xad8663715b08f41a3aec47cc,445760,1560004,138963707722
160386918,1702661873,1702661255,-618,0xad8663715b08f41a3aec47cc,445761,1567784,138963707722
160386919,1702661873,1702661255,-618,0xad8663715b08f41a3aec47cc,445762,1582092,138963707722
160386920,1702661873,1702661255,-618,0xad8663715b08f41a3aec47cc,445763,1511336,138963707722
160386921,1702661873,1702661255,-618,0xad8663715b08f41a3aec47cc,445764,1610394,138963707722
160386922,1702661873,1702661279,-594,0xad8663715b08f41a3aec47cc,445765,1556138,162727209792
160386923,1702661873,1702661303,-570,0xad8663715b08f41a3aec47cc,445766,1555946,143767334018
160386924,1702661873,1702661315,-558,0xad8663715b08f41a3aec47cc,445767,1607746,137889035168
160386925,1702661873,1702661315,-558,0xad8663715b08f41a3aec47cc,445768,1518642,137889035168
160386926,1702661873,1702661315,-558,0xad8663715b08f41a3aec47cc,445769,1585088,137889035168
160386927,1702661873,1702661315,-558,0xad8663715b08f41a3aec47cc,445770,1603678,137889035168
160386928,1702661873,1702661315,-558,0xad8663715b08f41a3aec47cc,445771,1606654,137889035168
160386929,1702661873,1702661315,-558,0xad8663715b08f41a3aec47cc,445772,1564018,137889035168
160386930,1702661873,1702661315,-558,0xad8663715b08f41a3aec47cc,445773,1575916,137889035168
160386931,1702661873,1702661315,-558,0xad8663715b08f41a3aec47cc,445774,1558530,137889035168
160386932,1702661873,1702661315,-558,0xad8663715b08f41a3aec47cc,445775,1552196,137889035168
160386933,1702661873,1702661315,-558,0xad8663715b08f41a3aec47cc,445776,1595184,137889035168
160386934,1702661873,1702661315,-558,0xad8663715b08f41a3aec47cc,445777,1584400,137889035168
160386935,1702661873,1702661315,-558,0xad8663715b08f41a3aec47cc,445778,1570192,137889035168
160386936,1702661873,1702661351,-522,0xad8663715b08f41a3aec47cc,445779,1589334,138504728816
160386937,1702661873,1702661351,-522,0xad8663715b08f41a3aec47cc,445780,1572474,138504728816
160386938,1702661873,1702661351,-522,0xad8663715b08f41a3aec47cc,445781,1555336,138504728816
160386939,1702661873,1702661351,-522,0xad8663715b08f41a3aec47cc,445782,1571404,138504728816
160386940,1702661873,1702661351,-522,0xad8663715b08f41a3aec47cc,445783,1561234,138504728816
160386941,1702661873,1702661351,-522,0xad8663715b08f41a3aec47cc,445784,1573244,138504728816
160386942,1702661873,1702661351,-522,0xad8663715b08f41a3aec47cc,445785,1583482,138504728816
160386943,1702661873,1702661351,-522,0xad8663715b08f41a3aec47cc,445786,1600232,138504728816
160386944,1702661873,1702661351,-522,0xad8663715b08f41a3aec47cc,445787,1558830,138504728816
160386945,1702661873,1702661351,-522,0xad8663715b08f41a3aec47cc,445788,1581404,138504728816
160386946,1702661873,1702661351,-522,0xad8663715b08f41a3aec47cc,445789,1549450,138504728816
160386947,1702661873,1702661351,-522,0xad8663715b08f41a3aec47cc,445790,1607478,138504728816
160386948,1702661873,1702661351,-522,0xad8663715b08f41a3aec47cc,445791,1555870,138504728816
160386949,1702661873,1702661351,-522,0xad8663715b08f41a3aec47cc,445792,1592430,138504728816
160386951,1702661873,1702661387,-486,0xad8663715b08f41a3aec47cc,445793,1593978,142714535615
160386952,1702661873,1702661387,-486,0xad8663715b08f41a3aec47cc,445794,1589040,142714535615
160386953,1702661873,1702661399,-474,0xad8663715b08f41a3aec47cc,445795,1599532,140775374200
160386954,1702661873,1702661399,-474,0xad8663715b08f41a3aec47cc,445796,1579142,140775374200
160386955,1702661873,1702661399,-474,0xad8663715b08f41a3aec47cc,445797,1603700,140775374200
160386956,1702661873,1702661399,-474,0xad8663715b08f41a3aec47cc,445798,1560646,140775374200
160386957,1702661873,1702661399,-474,0xad8663715b08f41a3aec47cc,445799,1593318,140775374200
160386958,1702661873,1702661399,-474,0xad8663715b08f41a3aec47cc,445800,1570218,140775374200
160386959,1702661873,1702661399,-474,0xad8663715b08f41a3aec47cc,445801,1587436,140775374200
160386960,1702661873,1702661399,-474,0xad8663715b08f41a3aec47cc,445802,1586792,140775374200
160386961,1702661873,1702661399,-474,0xad8663715b08f41a3aec47cc,445803,1580740,140775374200
160386962,1702661873,1702661399,-474,0xad8663715b08f41a3aec47cc,445804,1548666,140775374200
160386963,1702661873,1702661399,-474,0xad8663715b08f41a3aec47cc,445805,1482448,140775374200
160386964,1702661873,1702661399,-474,0xad8663715b08f41a3aec47cc,445806,1507734,140775374200
160386965,1702661873,1702661399,-474,0xad8663715b08f41a3aec47cc,445807,1601626,140775374200
160386966,1702661873,1702661435,-438,0xad8663715b08f41a3aec47cc,445808,1545124,143653189834
160386967,1702661873,1702661435,-438,0xad8663715b08f41a3aec47cc,445809,1555352,143653189834
160386968,1702661873,1702661435,-438,0xad8663715b08f41a3aec47cc,445810,1531070,143653189834
160386969,1702661873,1702661435,-438,0xad8663715b08f41a3aec47cc,445811,1545478,143653189834
160386970,1702661873,1702661435,-438,0xad8663715b08f41a3aec47cc,445812,1532486,143653189834
160386971,1702661873,1702661459,-414,0xad8663715b08f41a3aec47cc,445813,1591436,139758152098
160386972,1702661873,1702661459,-414,0xad8663715b08f41a3aec47cc,445814,1489008,139758152098
160386973,1702661873,1702661459,-414,0xad8663715b08f41a3aec47cc,445815,1570316,139758152098
160386974,1702661873,1702661459,-414,0xad8663715b08f41a3aec47cc,445816,1594944,139758152098
160386975,1702661873,1702661459,-414,0xad8663715b08f41a3aec47cc,445817,1544164,139758152098
160386976,1702661873,1702661459,-414,0xad8663715b08f41a3aec47cc,445818,1584068,139758152098
160386977,1702661873,1702661459,-414,0xad8663715b08f41a3aec47cc,445819,1605124,139758152098
160386978,1702661873,1702661459,-414,0xad8663715b08f41a3aec47cc,445820,1572138,139758152098
160386979,1702661873,1702661459,-414,0xad8663715b08f41a3aec47cc,445821,1535952,139758152098
160386980,1702661873,1702661459,-414,0xad8663715b08f41a3aec47cc,445822,1542934,139758152098
160386981,1702661873,1702661459,-414,0xad8663715b08f41a3aec47cc,445823,1538294,139758152098
160386982,1702661873,1702661459,-414,0xad8663715b08f41a3aec47cc,445824,1528558,139758152098
160386983,1702661873,1702661459,-414,0xad8663715b08f41a3aec47cc,445825,1607466,139758152098
160386984,1702661873,1702661459,-414,0xad8663715b08f41a3aec47cc,445826,1538566,139758152098
160386985,1702661873,1702661459,-414,0xad8663715b08f41a3aec47cc,445827,1547966,139758152098
160386986,1702661873,1702661495,-378,0xad8663715b08f41a3aec47cc,445828,1548604,141121717337
160386987,1702661873,1702661495,-378,0xad8663715b08f41a3aec47cc,445829,1594710,141121717337
160386988,1702661873,1702661495,-378,0xad8663715b08f41a3aec47cc,445830,1539112,141121717337
160386989,1702661873,1702661495,-378,0xad8663715b08f41a3aec47cc,445831,1591374,141121717337
160386990,1702661873,1702661495,-378,0xad8663715b08f41a3aec47cc,445832,1562496,141121717337
160386991,1702661873,1702661495,-378,0xad8663715b08f41a3aec47cc,445833,1558596,141121717337
160386992,1702661873,1702661495,-378,0xad8663715b08f41a3aec47cc,445834,1532518,141121717337
160386993,1702661873,1702661495,-378,0xad8663715b08f41a3aec47cc,445835,1595278,141121717337
160386994,1702661873,1702661495,-378,0xad8663715b08f41a3aec47cc,445836,1596364,141121717337
160386995,1702661873,1702661495,-378,0xad8663715b08f41a3aec47cc,445837,1523046,141121717337
160386996,1702661873,1702661495,-378,0xad8663715b08f41a3aec47cc,445838,1591700,141121717337
160386997,1702661873,1702661495,-378,0xad8663715b08f41a3aec47cc,445839,1611806,141121717337
160386998,1702661873,1702661495,-378,0xad8663715b08f41a3aec47cc,445840,1600496,141121717337
160386999,1702661873,1702661495,-378,0xad8663715b08f41a3aec47cc,445841,1575134,141121717337
160387000,1702661873,1702661531,-342,0xad8663715b08f41a3aec47cc,445842,1585428,143601444981
160387001,1702661873,1702661531,-342,0xad8663715b08f41a3aec47cc,445843,1560820,143601444981
160387003,1702661873,1702661567,-306,0xad8663715b08f41a3aec47cc,445844,1588118,136129474898
160387004,1702661873,1702661567,-306,0xad8663715b08f41a3aec47cc,445845,1560512,136129474898
160387005,1702661873,1702661567,-306,0xad8663715b08f41a3aec47cc,445846,1563202,136129474898
160387006,1702661873,1702661567,-306,0xad8663715b08f41a3aec47cc,445847,1524098,136129474898
160387007,1702661873,1702661567,-306,0xad8663715b08f41a3aec47cc,445848,1563448,136129474898
160387008,1702661873,1702661567,-306,0xad8663715b08f41a3aec47cc,445849,1576784,136129474898
160387009,1702661873,1702661567,-306,0xad8663715b08f41a3aec47cc,445850,1581508,136129474898
160387010,1702661873,1702661567,-306,0xad8663715b08f41a3aec47cc,445851,1610556,136129474898
160387011,1702661873,1702661567,-306,0xad8663715b08f41a3aec47cc,445852,1593786,136129474898
160387012,1702661873,1702661567,-306,0xad8663715b08f41a3aec47cc,445853,1601286,136129474898
160387013,1702661873,1702661567,-306,0xad8663715b08f41a3aec47cc,445854,1600586,136129474898
160387014,1702661873,1702661567,-306,0xad8663715b08f41a3aec47cc,445855,1533874,136129474898
160387015,1702661873,1702661567,-306,0xad8663715b08f41a3aec47cc,445856,1538700,136129474898
160387133,1702662248,1702661603,-645,0xad8663715b08f41a3aec47cc,445857,1564576,147880284966
160387134,1702662248,1702661615,-633,0xad8663715b08f41a3aec47cc,445858,1555986,144735142419
160387135,1702662248,1702661615,-633,0xad8663715b08f41a3aec47cc,445859,1530222,144735142419
160387136,1702662248,1702661615,-633,0xad8663715b08f41a3aec47cc,445860,1557448,144735142419
160387137,1702662248,1702661639,-609,0xad8663715b08f41a3aec47cc,445861,1608530,139996236846
160387138,1702662248,1702661639,-609,0xad8663715b08f41a3aec47cc,445862,1593908,139996236846
160387139,1702662248,1702661639,-609,0xad8663715b08f41a3aec47cc,445863,1577524,139996236846
160387140,1702662248,1702661639,-609,0xad8663715b08f41a3aec47cc,445864,1596094,139996236846
160387141,1702662248,1702661639,-609,0xad8663715b08f41a3aec47cc,445865,1608426,139996236846
160387142,1702662248,1702661639,-609,0xad8663715b08f41a3aec47cc,445866,1591066,139996236846
160387143,1702662248,1702661639,-609,0xad8663715b08f41a3aec47cc,445867,1593200,139996236846
160387144,1702662248,1702661639,-609,0xad8663715b08f41a3aec47cc,445868,1537908,139996236846
160387145,1702662248,1702661639,-609,0xad8663715b08f41a3aec47cc,445869,1587966,139996236846
160387146,1702662248,1702661639,-609,0xad8663715b08f41a3aec47cc,445870,1560372,139996236846
160387147,1702662248,1702661639,-609,0xad8663715b08f41a3aec47cc,445871,1539418,139996236846
160387148,1702662248,1702661639,-609,0xad8663715b08f41a3aec47cc,445872,1580070,139996236846
160387149,1702662248,1702661639,-609,0xad8663715b08f41a3aec47cc,445873,1595592,139996236846
160387150,1702662248,1702661639,-609,0xad8663715b08f41a3aec47cc,445874,1537342,139996236846
160387151,1702662248,1702661639,-609,0xad8663715b08f41a3aec47cc,445875,1566750,139996236846
160387152,1702662248,1702661675,-573,0xad8663715b08f41a3aec47cc,445876,1573312,144464822692
160387153,1702662248,1702661687,-561,0xad8663715b08f41a3aec47cc,445877,1592298,138720617228
160387154,1702662248,1702661687,-561,0xad8663715b08f41a3aec47cc,445878,1569052,138720617228
160387155,1702662248,1702661687,-561,0xad8663715b08f41a3aec47cc,445879,1603064,138720617228
160387156,1702662248,1702661687,-561,0xad8663715b08f41a3aec47cc,445880,1592436,138720617228
160387157,1702662248,1702661687,-561,0xad8663715b08f41a3aec47cc,445881,1574706,138720617228
160387158,1702662248,1702661687,-561,0xad8663715b08f41a3aec47cc,445882,1553620,138720617228
160387159,1702662248,1702661687,-561,0xad8663715b08f41a3aec47cc,445883,1552416,138720617228
160387160,1702662248,1702661687,-561,0xad8663715b08f41a3aec47cc,445884,1532908,138720617228
160387161,1702662248,1702661687,-561,0xad8663715b08f41a3aec47cc,445885,1584420,138720617228
160387162,1702662248,1702661687,-561,0xad8663715b08f41a3aec47cc,445886,1611958,138720617228
160387163,1702662248,1702661687,-561,0xad8663715b08f41a3aec47cc,445887,1562018,138720617228
160387164,1702662248,1702661687,-561,0xad8663715b08f41a3aec47cc,445888,1608112,138720617228
160387165,1702662248,1702661687,-561,0xad8663715b08f41a3aec47cc,445889,1561830,138720617228
160387166,1702662248,1702661687,-561,0xad8663715b08f41a3aec47cc,445890,1566000,138720617228
160387168,1702662248,1702661723,-525,0xad8663715b08f41a3aec47cc,445891,1606038,148237753253
160387169,1702662248,1702661735,-513,0xad8663715b08f41a3aec47cc,445892,1551864,140191352418
160387170,1702662248,1702661735,-513,0xad8663715b08f41a3aec47cc,445893,1539012,140191352418
160387171,1702662248,1702661735,-513,0xad8663715b08f41a3aec47cc,445894,1576742,140191352418
160387172,1702662248,1702661735,-513,0xad8663715b08f41a3aec47cc,445895,1613830,140191352418
160387173,1702662248,1702661735,-513,0xad8663715b08f41a3aec47cc,445896,1546302,140191352418
160387174,1702662248,1702661735,-513,0xad8663715b08f41a3aec47cc,445897,1581962,140191352418
160387175,1702662248,1702661735,-513,0xad8663715b08f41a3aec47cc,445898,1536590,140191352418
160387176,1702662248,1702661735,-513,0xad8663715b08f41a3aec47cc,445899,1535208,140191352418
160387177,1702662248,1702661735,-513,0xad8663715b08f41a3aec47cc,445900,1524014,140191352418
160387178,1702662248,1702661735,-513,0xad8663715b08f41a3aec47cc,445901,1520324,140191352418
160387179,1702662248,1702661735,-513,0xad8663715b08f41a3aec47cc,445902,1585030,140191352418
160387180,1702662248,1702661735,-513,0xad8663715b08f41a3aec47cc,445903,1546612,140191352418
160387181,1702662248,1702661735,-513,0xad8663715b08f41a3aec47cc,445904,1598002,140191352418
160387182,1702662248,1702661735,-513,0xad8663715b08f41a3aec47cc,445905,1531784,140191352418
160387183,1702662248,1702661771,-477,0xad8663715b08f41a3aec47cc,445906,1593536,141765915632
160387184,1702662248,1702661771,-477,0xad8663715b08f41a3aec47cc,445907,1585162,141765915632
160387185,1702662248,1702661771,-477,0xad8663715b08f41a3aec47cc,445908,1533976,141765915632
160387186,1702662248,1702661771,-477,0xad8663715b08f41a3aec47cc,445909,1569642,141765915632
160387187,1702662248,1702661771,-477,0xad8663715b08f41a3aec47cc,445910,1585524,141765915632
160387188,1702662248,1702661771,-477,0xad8663715b08f41a3aec47cc,445911,1551334,141765915632
160387189,1702662248,1702661771,-477,0xad8663715b08f41a3aec47cc,445912,1586172,141765915632
160387190,1702662248,1702661771,-477,0xad8663715b08f41a3aec47cc,445913,1605674,141765915632
160387191,1702662248,1702661771,-477,0xad8663715b08f41a3aec47cc,445914,1559438,141765915632
160387192,1702662248,1702661771,-477,0xad8663715b08f41a3aec47cc,445915,1543584,141765915632
160387193,1702662248,1702661771,-477,0xad8663715b08f41a3aec47cc,445916,1581794,141765915632
160387194,1702662248,1702661795,-453,0xad8663715b08f41a3aec47cc,445917,1578608,150480872768
160387195,1702662248,1702661819,-429,0xad8663715b08f41a3aec47cc,445918,1601928,133594103743
160387196,1702662248,1702661819,-429,0xad8663715b08f41a3aec47cc,445919,1595436,133594103743
160387197,1702662248,1702661819,-429,0xad8663715b08f41a3aec47cc,445920,1586558,133594103743
160387198,1702662248,1702661819,-429,0xad8663715b08f41a3aec47cc,445921,1545188,133594103743
160387199,1702662248,1702661819,-429,0xad8663715b08f41a3aec47cc,445922,1590258,133594103743
160387200,1702662248,1702661819,-429,0xad8663715b08f41a3aec47cc,445923,1579562,133594103743
160387201,1702662248,1702661819,-429,0xad8663715b08f41a3aec47cc,445924,1511468,133594103743
160387202,1702662248,1702661819,-429,0xad8663715b08f41a3aec47cc,445925,1603740,133594103743
160387203,1702662248,1702661819,-429,0xad8663715b08f41a3aec47cc,445926,1597728,133594103743
160387204,1702662248,1702661819,-429,0xad8663715b08f41a3aec47cc,445927,1614696,133594103743
160387205,1702662248,1702661819,-429,0xad8663715b08f41a3aec47cc,445928,1521916,133594103743
160387206,1702662248,1702661819,-429,0xad8663715b08f41a3aec47cc,445929,1585520,133594103743
160387207,1702662248,1702661819,-429,0xad8663715b08f41a3aec47cc,445930,1607478,133594103743
160387208,1702662248,1702661819,-429,0xad8663715b08f41a3aec47cc,445931,1561898,133594103743
160387209,1702662248,1702661843,-405,0xad8663715b08f41a3aec47cc,445932,1541152,146001437613
160387210,1702662248,1702661855,-393,0xad8663715b08f41a3aec47cc,445933,1608818,138906142483
160387211,1702662248,1702661855,-393,0xad8663715b08f41a3aec47cc,445934,1523976,138906142483
160387212,1702662248,1702661855,-393,0xad8663715b08f41a3aec47cc,445935,1571986,138906142483
160387213,1702662248,1702661855,-393,0xad8663715b08f41a3aec47cc,445936,1595124,138906142483
160387214,1702662248,1702661855,-393,0xad8663715b08f41a3aec47cc,445937,1543596,138906142483
160387215,1702662248,1702661855,-393,0xad8663715b08f41a3aec47cc,445938,1594098,138906142483
160387216,1702662248,1702661855,-393,0xad8663715b08f41a3aec47cc,445939,1584692,138906142483
160387217,1702662248,1702661855,-393,0xad8663715b08f41a3aec47cc,445940,1588804,138906142483
160387218,1702662248,1702661855,-393,0xad8663715b08f41a3aec47cc,445941,1589516,138906142483
160387219,1702662248,1702661855,-393,0xad8663715b08f41a3aec47cc,445942,1599816,138906142483
160387220,1702662248,1702661855,-393,0xad8663715b08f41a3aec47cc,445943,1612570,138906142483
160387221,1702662248,1702661855,-393,0xad8663715b08f41a3aec47cc,445944,1552070,138906142483
160387222,1702662248,1702661855,-393,0xad8663715b08f41a3aec47cc,445945,1552566,138906142483
160387223,1702662248,1702661855,-393,0xad8663715b08f41a3aec47cc,445946,1539138,138906142483
160387224,1702662248,1702661891,-357,0xad8663715b08f41a3aec47cc,445947,1608012,135929017500
160387225,1702662248,1702661891,-357,0xad8663715b08f41a3aec47cc,445948,1575000,135929017500
160387226,1702662248,1702661891,-357,0xad8663715b08f41a3aec47cc,445949,1532310,135929017500
160387227,1702662248,1702661891,-357,0xad8663715b08f41a3aec47cc,445950,1583854,135929017500
160387228,1702662248,1702661891,-357,0xad8663715b08f41a3aec47cc,445951,1602926,135929017500
160387229,1702662248,1702661891,-357,0xad8663715b08f41a3aec47cc,445952,1594458,135929017500
160387230,1702662248,1702661891,-357,0xad8663715b08f41a3aec47cc,445953,1549384,135929017500
160387231,1702662248,1702661891,-357,0xad8663715b08f41a3aec47cc,445954,1581440,135929017500
160387232,1702662248,1702661891,-357,0xad8663715b08f41a3aec47cc,445955,1585556,135929017500
160387233,1702662248,1702661891,-357,0xad8663715b08f41a3aec47cc,445956,1593542,135929017500
160387234,1702662248,1702661891,-357,0xad8663715b08f41a3aec47cc,445957,1549504,135929017500
160387235,1702662248,1702661891,-357,0xad8663715b08f41a3aec47cc,445958,1599592,135929017500
160387236,1702662248,1702661891,-357,0xad8663715b08f41a3aec47cc,445959,1558364,135929017500
160387237,1702662248,1702661891,-357,0xad8663715b08f41a3aec47cc,445960,1600314,135929017500
160387238,1702662248,1702661927,-321,0xad8663715b08f41a3aec47cc,445961,1528494,137401885151
160387239,1702662248,1702661927,-321,0xad8663715b08f41a3aec47cc,445962,1607382,137401885151
160387240,1702662248,1702661927,-321,0xad8663715b08f41a3aec47cc,445963,1544014,137401885151
160387241,1702662248,1702661927,-321,0xad8663715b08f41a3aec47cc,445964,1603104,137401885151
160387242,1702662248,1702661927,-321,0xad8663715b08f41a3aec47cc,445965,1556334,137401885151
160387243,1702662248,1702661927,-321,0xad8663715b08f41a3aec47cc,445966,1581248,137401885151
160387244,1702662248,1702661927,-321,0xad8663715b08f41a3aec47cc,445967,1615148,137401885151
160387245,1702662248,1702661927,-321,0xad8663715b08f41a3aec47cc,445968,1595138,137401885151
160387246,1702662248,1702661927,-321,0xad8663715b08f41a3aec47cc,445969,1568890,137401885151
160387247,1702662248,1702661927,-321,0xad8663715b08f41a3aec47cc,445970,1582988,137401885151
160387248,1702662248,1702661927,-321,0xad8663715b08f41a3aec47cc,445971,1600180,137401885151
160387249,1702662248,1702661927,-321,0xad8663715b08f41a3aec47cc,445972,1613048,137401885151
160387250,1702662248,1702661927,-321,0xad8663715b08f41a3aec47cc,445973,1560938,137401885151
160387251,1702662248,1702661927,-321,0xad8663715b08f41a3aec47cc,445974,1559420,137401885151
160387252,1702662248,1702661963,-285,0xad8663715b08f41a3aec47cc,445975,1541850,143178006282
160387253,1702662248,1702661963,-285,0xad8663715b08f41a3aec47cc,445976,1536236,143178006282
160387254,1702662248,1702661963,-285,0xad8663715b08f41a3aec47cc,445977,1534576,143178006282
160387255,1702662248,1702661963,-285,0xad8663715b08f41a3aec47cc,445978,1513628,143178006282
160387256,1702662248,1702661963,-285,0xad8663715b08f41a3aec47cc,445979,1569258,143178006282
160387257,1702662248,1702661963,-285,0xad8663715b08f41a3aec47cc,445980,1575148,143178006282
160387258,1702662248,1702661963,-285,0xad8663715b08f41a3aec47cc,445981,1553936,143178006282
160387301,1702662637,1702661987,-650,0xad8663715b08f41a3aec47cc,445982,1612884,144246594594
160387302,1702662637,1702661987,-650,0xad8663715b08f41a3aec47cc,445983,1531334,144246594594
160387303,1702662637,1702661999,-638,0xad8663715b08f41a3aec47cc,445984,1595218,140454337198
160387304,1702662637,1702661999,-638,0xad8663715b08f41a3aec47cc,445985,1610398,140454337198
160387305,1702662637,1702661999,-638,0xad8663715b08f41a3aec47cc,445986,1559416,140454337198
160387306,1702662637,1702661999,-638,0xad8663715b08f41a3aec47cc,445987,1602686,140454337198
160387307,1702662637,1702661999,-638,0xad8663715b08f41a3aec47cc,445988,1588666,140454337198
160387308,1702662637,1702661999,-638,0xad8663715b08f41a3aec47cc,445989,1583782,140454337198
160387309,1702662637,1702661999,-638,0xad8663715b08f41a3aec47cc,445990,1535234,140454337198
160387310,1702662637,1702661999,-638,0xad8663715b08f41a3aec47cc,445991,1570626,140454337198
160387311,1702662637,1702661999,-638,0xad8663715b08f41a3aec47cc,445992,1586504,140454337198
160387312,1702662637,1702661999,-638,0xad8663715b08f41a3aec47cc,445993,1610264,140454337198
160387313,1702662637,1702661999,-638,0xad8663715b08f41a3aec47cc,445994,1603036,140454337198
160387314,1702662637,1702661999,-638,0xad8663715b08f41a3aec47cc,445995,1548846,140454337198
160387315,1702662637,1702661999,-638,0xad8663715b08f41a3aec47cc,445996,1554414,140454337198
160387316,1702662637,1702662023,-614,0xad8663715b08f41a3aec47cc,445997,1567024,144733139865
160387317,1702662637,1702662023,-614,0xad8663715b08f41a3aec47cc,445998,1570532,144733139865
160387318,1702662637,1702662023,-614,0xad8663715b08f41a3aec47cc,445999,1554180,144733139865
160387319,1702662637,1702662023,-614,0xad8663715b08f41a3aec47cc,446000,1562378,144733139865
160387320,1702662637,1702662047,-590,0xad8663715b08f41a3aec47cc,446001,1597266,139118959901
160387321,1702662637,1702662047,-590,0xad8663715b08f41a3aec47cc,446002,1553248,139118959901
160387322,1702662637,1702662047,-590,0xad8663715b08f41a3aec47cc,446003,1615026,139118959901
160387323,1702662637,1702662047,-590,0xad8663715b08f41a3aec47cc,446004,1586342,139118959901
160387324,1702662637,1702662047,-590,0xad8663715b08f41a3aec47cc,446005,1566386,139118959901
160387325,1702662637,1702662047,-590,0xad8663715b08f41a3aec47cc,446006,1572296,139118959901
160387326,1702662637,1702662047,-590,0xad8663715b08f41a3aec47cc,446007,1545614,139118959901
160387327,1702662637,1702662047,-590,0xad8663715b08f41a3aec47cc,446008,1577200,139118959901
160387328,1702662637,1702662047,-590,0xad8663715b08f41a3aec47cc,446009,1604380,139118959901
160387329,1702662637,1702662047,-590,0xad8663715b08f41a3aec47cc,446010,1592698,139118959901
160387330,1702662637,1702662047,-590,0xad8663715b08f41a3aec47cc,446011,1597730,139118959901
160387331,1702662637,1702662047,-590,0xad8663715b08f41a3aec47cc,446012,1592130,139118959901
160387332,1702662637,1702662047,-590,0xad8663715b08f41a3aec47cc,446013,1586274,139118959901
160387333,1702662637,1702662047,-590,0xad8663715b08f41a3aec47cc,446014,1546378,139118959901
160387334,1702662637,1702662047,-590,0xad8663715b08f41a3aec47cc,446015,1577778,139118959901
160387335,1702662637,1702662083,-554,0xad8663715b08f41a3aec47cc,446016,1575350,137107563448
160387336,1702662637,1702662083,-554,0xad8663715b08f41a3aec47cc,446017,1560020,137107563448
160387337,1702662637,1702662083,-554,0xad8663715b08f41a3aec47cc,446018,1585720,137107563448
160387338,1702662637,1702662083,-554,0xad8663715b08f41a3aec47cc,446019,1582768,137107563448
160387339,1702662637,1702662083,-554,0xad8663715b08f41a3aec47cc,446020,1603648,137107563448
160387340,1702662637,1702662083,-554,0xad8663715b08f41a3aec47cc,446021,1612836,137107563448
160387341,1702662637,1702662083,-554,0xad8663715b08f41a3aec47cc,446022,1543046,137107563448
160387342,1702662637,1702662083,-554,0xad8663715b08f41a3aec47cc,446023,1573378,137107563448
160387343,1702662637,1702662083,-554,0xad8663715b08f41a3aec47cc,446024,1601282,137107563448
160387344,1702662637,1702662083,-554,0xad8663715b08f41a3aec47cc,446025,1573910,137107563448
160387345,1702662637,1702662083,-554,0xad8663715b08f41a3aec47cc,446026,1576616,137107563448
160387346,1702662637,1702662083,-554,0xad8663715b08f41a3aec47cc,446027,1570848,137107563448
160387347,1702662637,1702662083,-554,0xad8663715b08f41a3aec47cc,446028,1607342,137107563448
160387348,1702662637,1702662119,-518,0xad8663715b08f41a3aec47cc,446029,1586620,140411816850
160387349,1702662637,1702662119,-518,0xad8663715b08f41a3aec47cc,446030,1601450,140411816850
160387350,1702662637,1702662119,-518,0xad8663715b08f41a3aec47cc,446031,1565552,140411816850
160387351,1702662637,1702662119,-518,0xad8663715b08f41a3aec47cc,446032,1595346,140411816850
160387352,1702662637,1702662119,-518,0xad8663715b08f41a3aec47cc,446033,1533022,140411816850
160387353,1702662637,1702662119,-518,0xad8663715b08f41a3aec47cc,446034,1595516,140411816850
160387354,1702662637,1702662119,-518,0xad8663715b08f41a3aec47cc,446035,1593488,140411816850
160387355,1702662637,1702662119,-518,0xad8663715b08f41a3aec47cc,446036,1595842,140411816850
160387356,1702662637,1702662119,-518,0xad8663715b08f41a3aec47cc,446037,1552724,140411816850
160387357,1702662637,1702662119,-518,0xad8663715b08f41a3aec47cc,446038,1592848,140411816850
160387358,1702662637,1702662119,-518,0xad8663715b08f41a3aec47cc,446039,1604824,140411816850
160387359,1702662637,1702662119,-518,0xad8663715b08f41a3aec47cc,446040,1554916,140411816850
160387360,1702662637,1702662119,-518,0xad8663715b08f41a3aec47cc,446041,1584094,140411816850
160387361,1702662637,1702662119,-518,0xad8663715b08f41a3aec47cc,446042,1579994,140411816850
160387362,1702662637,1702662155,-482,0xad8663715b08f41a3aec47cc,446043,1552550,139340984898
160387363,1702662637,1702662155,-482,0xad8663715b08f41a3aec47cc,446044,1556672,139340984898
160387364,1702662637,1702662155,-482,0xad8663715b08f41a3aec47cc,446045,1545390,139340984898
160387365,1702662637,1702662155,-482,0xad8663715b08f41a3aec47cc,446046,1595120,139340984898
160387366,1702662637,1702662155,-482,0xad8663715b08f41a3aec47cc,446047,1590288,139340984898
160387367,1702662637,1702662155,-482,0xad8663715b08f41a3aec47cc,446048,1583402,139340984898
160387368,1702662637,1702662155,-482,0xad8663715b08f41a3aec47cc,446049,1575210,139340984898
160387369,1702662637,1702662155,-482,0xad8663715b08f41a3aec47cc,446050,1545294,139340984898
160387370,1702662637,1702662155,-482,0xad8663715b08f41a3aec47cc,446051,1580942,139340984898
160387371,1702662637,1702662155,-482,0xad8663715b08f41a3aec47cc,446052,1601878,139340984898
160387372,1702662637,1702662155,-482,0xad8663715b08f41a3aec47cc,446053,1586764,139340984898
160387373,1702662637,1702662155,-482,0xad8663715b08f41a3aec47cc,446054,1602478,139340984898
160387374,1702662637,1702662155,-482,0xad8663715b08f41a3aec47cc,446055,1600276,139340984898
160387375,1702662637,1702662155,-482,0xad8663715b08f41a3aec47cc,446056,1575312,139340984898
160387376,1702662637,1702662155,-482,0xad8663715b08f41a3aec47cc,446057,1609558,139340984898
160387379,1702662637,1702662191,-446,0xad8663715b08f41a3aec47cc,446058,1608340,140100573078
160387380,1702662637,1702662191,-446,0xad8663715b08f41a3aec47cc,446059,1592202,140100573078
160387381,1702662637,1702662191,-446,0xad8663715b08f41a3aec47cc,446060,1555774,140100573078
160387382,1702662637,1702662191,-446,0xad8663715b08f41a3aec47cc,446061,1564410,140100573078
160387383,1702662637,1702662191,-446,0xad8663715b08f41a3aec47cc,446062,1587118,140100573078
160387384,1702662637,1702662215,-422,0xad8663715b08f41a3aec47cc,446063,1636468,134288994722
160387385,1702662637,1702662215,-422,0xad8663715b08f41a3aec47cc,446064,1608988,134288994722
160387386,1702662637,1702662215,-422,0xad8663715b08f41a3aec47cc,446065,1609790,134288994722
160387387,1702662637,1702662215,-422,0xad8663715b08f41a3aec47cc,446066,1612902,134288994722
160387388,1702662637,1702662215,-422,0xad8663715b08f41a3aec47cc,446067,1563190,134288994722
160387389,1702662637,1702662215,-422,0xad8663715b08f41a3aec47cc,446068,1605734,134288994722
160387390,1702662637,1702662215,-422,0xad8663715b08f41a3aec47cc,446069,1594848,134288994722
160387391,1702662637,1702662215,-422,0xad8663715b08f41a3aec47cc,446070,1583306,134288994722
160387392,1702662637,1702662215,-422,0xad8663715b08f41a3aec47cc,446071,1585770,134288994722
160387393,1702662637,1702662215,-422,0xad8663715b08f41a3aec47cc,446072,1615334,134288994722
160387394,1702662637,1702662215,-422,0xad8663715b08f41a3aec47cc,446073,1585272,134288994722
160387395,1702662637,1702662215,-422,0xad8663715b08f41a3aec47cc,446074,1610580,134288994722
160387396,1702662637,1702662215,-422,0xad8663715b08f41a3aec47cc,446075,1579874,134288994722
160387397,1702662637,1702662215,-422,0xad8663715b08f41a3aec47cc,446076,1596960,134288994722
160387398,1702662637,1702662215,-422,0xad8663715b08f41a3aec47cc,446077,1599256,134288994722
160387399,1702662637,1702662239,-398,0xad8663715b08f41a3aec47cc,446078,1585100,142738063177
160387400,1702662637,1702662239,-398,0xad8663715b08f41a3aec47cc,446079,1586436,142738063177
160387401,1702662637,1702662251,-386,0xad8663715b08f41a3aec47cc,446080,1606218,140533532076
160387402,1702662637,1702662251,-386,0xad8663715b08f41a3aec47cc,446081,1595632,140533532076
160387403,1702662637,1702662251,-386,0xad8663715b08f41a3aec47cc,446082,1588110,140533532076
160387404,1702662637,1702662251,-386,0xad8663715b08f41a3aec47cc,446083,1593732,140533532076
160387405,1702662637,1702662251,-386,0xad8663715b08f41a3aec47cc,446084,1595678,140533532076
160387406,1702662637,1702662251,-386,0xad8663715b08f41a3aec47cc,446085,1588128,140533532076
160387407,1702662637,1702662251,-386,0xad8663715b08f41a3aec47cc,446086,1600208,140533532076
160387408,1702662637,1702662251,-386,0xad8663715b08f41a3aec47cc,446087,1608150,140533532076
160387409,1702662637,1702662251,-386,0xad8663715b08f41a3aec47cc,446088,1611040,140533532076
160387410,1702662637,1702662251,-386,0xad8663715b08f41a3aec47cc,446089,1594026,140533532076
160387411,1702662637,1702662251,-386,0xad8663715b08f41a3aec47cc,446090,1602300,140533532076
160387412,1702662637,1702662251,-386,0xad8663715b08f41a3aec47cc,446091,1580496,140533532076
160387413,1702662637,1702662251,-386,0xad8663715b08f41a3aec47cc,446092,1600612,140533532076
160387414,1702662637,1702662275,-362,0xad8663715b08f41a3aec47cc,446093,1532938,144482846849
160387415,1702662637,1702662287,-350,0xad8663715b08f41a3aec47cc,446094,1597652,137341410101
160387416,1702662637,1702662287,-350,0xad8663715b08f41a3aec47cc,446095,1584058,137341410101
160387417,1702662637,1702662287,-350,0xad8663715b08f41a3aec47cc,446096,1605570,137341410101
160387418,1702662637,1702662287,-350,0xad8663715b08f41a3aec47cc,446097,1592274,137341410101
160387419,1702662637,1702662287,-350,0xad8663715b08f41a3aec47cc,446098,1599584,137341410101
160387420,1702662637,1702662287,-350,0xad8663715b08f41a3aec47cc,446099,1598534,137341410101
160387421,1702662637,1702662287,-350,0xad8663715b08f41a3aec47cc,446100,1598324,137341410101
160387422,1702662637,1702662287,-350,0xad8663715b08f41a3aec47cc,446101,1602592,137341410101
160387423,1702662637,1702662287,-350,0xad8663715b08f41a3aec47cc,446102,1603948,137341410101
160387424,1702662637,1702662287,-350,0xad8663715b08f41a3aec47cc,446103,1599000,137341410101
160387425,1702662637,1702662287,-350,0xad8663715b08f41a3aec47cc,446104,1595048,137341410101
160387426,1702662637,1702662287,-350,0xad8663715b08f41a3aec47cc,446105,1587876,137341410101
160387427,1702662637,1702662287,-350,0xad8663715b08f41a3aec47cc,446106,1601652,137341410101
160387428,1702662637,1702662287,-350,0xad8663715b08f41a3aec47cc,446107,1638770,137341410101
160387429,1702662637,1702662323,-314,0xad8663715b08f41a3aec47cc,446108,1599054,146135468281
160387430,1702662637,1702662335,-302,0xad8663715b08f41a3aec47cc,446109,1642366,137225492575
160387431,1702662637,1702662335,-302,0xad8663715b08f41a3aec47cc,446110,1642504,137225492575
160387432,1702662637,1702662335,-302,0xad8663715b08f41a3aec47cc,446111,1635904,137225492575
160387433,1702662637,1702662335,-302,0xad8663715b08f41a3aec47cc,446112,1634002,137225492575
160387434,1702662637,1702662335,-302,0xad8663715b08f41a3aec47cc,446113,1644292,137225492575
160387435,1702662637,1702662335,-302,0xad8663715b08f41a3aec47cc,446114,1638230,137225492575
160387436,1702662637,1702662335,-302,0xad8663715b08f41a3aec47cc,446115,1606620,137225492575
160387437,1702662637,1702662335,-302,0xad8663715b08f41a3aec47cc,446116,1612686,137225492575
160387438,1702662637,1702662335,-302,0xad8663715b08f41a3aec47cc,446117,1599476,137225492575
160387439,1702662637,1702662335,-302,0xad8663715b08f41a3aec47cc,446118,1587306,137225492575
160387440,1702662637,1702662335,-302,0xad8663715b08f41a3aec47cc,446119,1604714,137225492575
160387441,1702662637,1702662335,-302,0xad8663715b08f41a3aec47cc,446120,1588834,137225492575
160387442,1702662637,1702662335,-302,0xad8663715b08f41a3aec47cc,446121,1611830,137225492575
160387443,1702662637,1702662335,-302,0xad8663715b08f41a3aec47cc,446122,1616960,137225492575